date (UTC),description,moneyIn (Satoshi),moneyOut (Satoshi),tx hash,current balance (Satoshi)
2022-11-18T12:09:57Z,PAYMENT RECEIVED,654958387,0,71113d6566c1054fcd320a3526a1f2a352310bda7ec977dc6b40f0f115167056,17584747631
2022-11-18T12:09:22Z,PAYMENT RECEIVED,676455986,0,9a198579c981d43c9df4712c185f7ce87ea776ce51b564c594658b8eecb8c88f,16929789244
2022-11-18T11:41:37Z,PAYMENT RECEIVED,656155598,0,5e845fc9ad0fcd378ac934ed58812cf8d0525986c5dbf9b90ff8d76d30fcb2ab,16253333258
2022-11-18T11:23:22Z,PAYMENT RECEIVED,644653552,0,49fc7415622c3549a1e40506a43ac35d3506d8c18fda611824a43d69b82b04cb,15597177660
2022-11-18T10:57:52Z,PAYMENT SENT,0,-647367067,99ffe28b901b230dfbb73d3eff265655e2656c4ec58c133c4138b033aabd788e,14952524108
2022-11-18T10:26:29Z,PAYMENT RECEIVED,648770938,0,73258f77316d43bd98612834c900844ffb32285d124b852df75cf0b1cdbebfc2,15599891175
2022-11-18T09:54:30Z,PAYMENT SENT,0,-1970133227,6b24365a0c4a6efd414a0be23fba71d4a76a288524938b1814d55b57a7fc03a1,14951120237
2022-11-18T09:24:03Z,PAYMENT RECEIVED,648046788,0,822e4a2cd331e3b3cc511b117f0a4c0c952fa65a8c05a7e51f52bda85faca796,16921253464
2022-11-18T09:14:24Z,PAYMENT RECEIVED,665740324,0,162e8c52d4e656223458f5b2965d798deb0eb8e907aef634e55c90d40a0c8757,16273206676
2022-11-18T09:02:30Z,PAYMENT RECEIVED,673754102,0,809bce8162cb43b707236993e3611d327b020a2f0d2593a6cbb33d48b6f538e1,15607466352
2022-11-18T06:53:35Z,PAYMENT RECEIVED,664467107,0,25d39069bcd350aa9128fb630a439705b37c31900d0411cf943dc0e0b25f3d13,15572489862
2022-11-18T06:53:35Z,PAYMENT SENT,0,-638777612,356cdc2aeca5f4f019225d75efe210b8b9fc41b22a5d33115cade51d28c33438,14933712250
2022-11-18T06:30:26Z,PAYMENT RECEIVED,644587156,0,6067849b4d4676d78e1447fd6d0ebd725c642a1af923734b8513250c088aeae0,14908022755
2022-11-18T05:36:49Z,PAYMENT RECEIVED,650745074,0,6a9e32b5068f06800ddbc373a13f453cf2c7e74b3ce45c865c7ed25e4bc96b49,14263435599
2022-11-18T03:38:13Z,PAYMENT RECEIVED,645869487,0,96a6fdb5937d250aaa4a52d12a1f2691c65d6b9a3d650618c6d8c5ea6a57431a,13612690525
2022-11-18T02:23:57Z,PAYMENT RECEIVED,643633180,0,de7a4feef965505836eca0408808d88f8866ced4f3ebd825aecac48c82b6c6b2,12966821038
2022-11-18T02:05:39Z,PAYMENT SENT,0,-10321883632,1bee420756a3bc24a37efeab19b53992bcd894add983d3e154cdce0628f611e8,12323187858
2022-11-18T01:55:45Z,PAYMENT RECEIVED,656320627,0,f28b25396a2ace3b0178864d30529d0e0ab08254c7e2e9957ce9a5077f94af05,22645071490
2022-11-17T22:45:12Z,PAYMENT RECEIVED,666755221,0,baf565cfb8cf4a155c1016713a9556d3aa0e9f03d2635b1e326cbaa105fcd5fb,21988750863
2022-11-17T22:28:37Z,PAYMENT RECEIVED,668342438,0,5517feb975120a8f90780c3fb28d3b91d8851d46695c5383a84e3c1eeedfb2ae,21321995642
2022-11-17T20:20:44Z,PAYMENT RECEIVED,666717443,0,21c9a87b4e9cd859ba71b451b31a5eb67359bebfc0c289c67c8fdc0de9f93a2b,20653653204
2022-11-17T17:35:57Z,PAYMENT SENT,0,-7195802595,cc2bc04987d039b506cc52222fa8c41a4c8e10e1e84ae9c3195a185654095349,19986935761
2022-11-17T14:09:34Z,PAYMENT RECEIVED,657479668,0,61e3da3b120c4f091d5c18b2058327ebfba2d6a295b302d90592dca29ca53342,27182738356
2022-11-17T13:47:20Z,PAYMENT RECEIVED,639473130,0,3d5fa78b3e2bdee445c819544b9a37cf99238dd09aa633456e189b13127a3e40,26525258688
2022-11-17T13:36:31Z,PAYMENT RECEIVED,642560661,0,7e58f49975c315cbd9aa9e0270f5d29cd3feb814d9932ae3c11bd81c91f577dd,25885785558
2022-11-17T13:09:20Z,PAYMENT RECEIVED,642436812,0,a5f501cdb59e7d44d285272ca9f511a8f97b0a8df287fbe325ae5a8bc7f97b10,25243224897
2022-11-17T13:04:45Z,PAYMENT RECEIVED,654007721,0,797c82dd5c05883b12e225a8367c1e8a09261af0b70f7ebf512d17092041cd3e,24600788085
2022-11-17T12:42:16Z,PAYMENT SENT,0,-1978380925,5d375f201a35c388c64defced09f4fb64e555e72bb42c6ecef48c5953a1cd650,23946780364
2022-11-17T12:28:37Z,PAYMENT RECEIVED,647367067,0,74201041f86d796f36d5f4c46a906fe4295a56a5a740850dbe1a6b1eb8cd01b8,25925161289
2022-11-17T11:59:46Z,PAYMENT RECEIVED,641423986,0,26094c6c8913b9c9aabc6252e9cca939d0a3930c38939f73d10438c2b7880ee9,25277794222
2022-11-17T11:19:59Z,PAYMENT RECEIVED,639053849,0,246398818c89187662912b1fd10663e893c70a5c2d113f3e1836c2af3a86b27b,24636370236
2022-11-17T10:49:24Z,PAYMENT RECEIVED,658645838,0,5133fad21badc379ec82c70f4ad91f6a53b98252434b632be7fdf2d5b304941c,23997316387
2022-11-17T09:59:59Z,PAYMENT RECEIVED,641385102,0,d61dccb3cd9df14c7a94e305502f8ef952b9b685bc1124d4f88308f40486a62a,23338670549
2022-11-17T08:20:22Z,PAYMENT RECEIVED,647385316,0,6dd6d6583bea4483c34b38333e2e66ada58eaeca359df67b4105ddb2effe7a41,22697285447
2022-11-17T07:52:25Z,PAYMENT RECEIVED,640803760,0,c62ac5b6fd72ae4939ab392422afef21b706ee8b64c269620b59a62ebc3a8cfa,22049900131
2022-11-17T07:35:58Z,PAYMENT RECEIVED,639832100,0,2bb47d258888fd34d8f58a01b837d5532922dbf7b7ba86e83c7801abea214685,21409096371
2022-11-17T07:12:40Z,PAYMENT RECEIVED,643451810,0,952aa874932d773b5e0ae41854db267a8d08e834cab94042aa480c1d6728f594,20769264271
2022-11-17T07:03:13Z,PAYMENT RECEIVED,643183124,0,a708ba7ba7224cf5b2f89fa48124329d8bc2a890fe726edb44d22bacbfcdae05,20125812461
2022-11-17T05:23:37Z,PAYMENT RECEIVED,644718511,0,7b748e59d0e64ab0e23aac751f4aed9fea41d48b789684d27de1965ed26835a0,19482629337
2022-11-17T05:03:57Z,PAYMENT RECEIVED,638777612,0,badc937eff4992cfec198fe5de75e5b3300781c492dd6b203f934cc39ae33393,18837910826
2022-11-17T04:57:25Z,PAYMENT RECEIVED,641300335,0,7cc8ea6c54eb5fb845bb5e0c00b2a9b9b3652ee755686db80fd7219a596b7913,18199133214
2022-11-17T03:57:43Z,PAYMENT RECEIVED,660354545,0,afe6a4f3a0d89551eacbf72723dd1e45762ec1aef658641dd56b963a9ab0e873,17557832879
2022-11-17T02:37:18Z,PAYMENT RECEIVED,642984564,0,d23cd8217034e9588b0a8afd2341a8cfab09aac57c95592070eab9d2a2c4ab67,16897478334
2022-11-17T02:14:05Z,PAYMENT SENT,0,-9701980808,ed3cf419063c8a9f15aa6b1626b5b94b1cac7111db28efc9d8a8f9e9fea2da2c,16254493770
2022-11-17T01:43:57Z,PAYMENT RECEIVED,640461759,0,7cf0b9053a74c77e0bd671db11ec56471c411bdd1e516b7779e4731ec4ff85e1,25956474578
2022-11-17T01:37:26Z,PAYMENT RECEIVED,652069479,0,401391a7939a669d7bfc6c0379796e910c705ddd1fdb94b42d22eeeaf9a8bcb1,25316012819
2022-11-17T00:47:46Z,PAYMENT RECEIVED,651161430,0,a1b59dd9b16c8f74375330727cf852462cc0e1cc2498d23ab440f016a2e2bb98,24663943340
2022-11-17T00:05:33Z,PAYMENT RECEIVED,651026466,0,90d7426b313983f3eacab7f56c27811bac5ec3b3bd3ffe5db63e33c5050de42a,24012781910
2022-11-16T23:41:07Z,PAYMENT RECEIVED,642512323,0,fe4d0635bcbdeffa6378dc37637f49f4de370bf304d2712c497d4d48648ab1c0,23361755444
2022-11-16T23:37:45Z,PAYMENT RECEIVED,644235412,0,1833a15f2a69d0ef0925302b4f9968ada845e2024df984e4aa747d7aca180d23,22719243121
2022-11-16T23:24:21Z,PAYMENT RECEIVED,649671202,0,33182ec4aeedc4af98a0bcee7a620baf923434ad3bfed82f88c8bddb82de8a0f,22075007709
2022-11-16T23:13:33Z,PAYMENT RECEIVED,644615666,0,f91bc91a116db097708b59067349377c2cd63cf0c9e1c5198ea9489f944328e4,21425336507
2022-11-16T22:52:05Z,PAYMENT RECEIVED,667784628,0,8711ed4f6bab0c26fc1745745b4a12f4b305e7901afa11421a9ec2120a3db280,20780720841
2022-11-16T22:18:29Z,PAYMENT RECEIVED,662244001,0,a349ce9af601fef9168c71f25cab47bf8859ecf6ae9142bc8b7b1b909e531b18,20112936213
2022-11-16T21:56:09Z,PAYMENT RECEIVED,656289997,0,b1fbda0e45d8e60a38986aa64bf0fee2588c8bc00658b65f5bd2fd3e48e03f99,19450692212
2022-11-16T21:13:03Z,PAYMENT RECEIVED,659624643,0,8f9c5b62c7854534a3f3e3c3dc8331ffc6f4a6ec55248e0ef65a11d870db936c,18794402215
2022-11-16T19:45:24Z,PAYMENT RECEIVED,642900630,0,d28e267f656d9cc7c53776dfc187e25efaed870639451a9d88f9d336230aae05,18134777572
2022-11-16T19:42:14Z,PAYMENT SENT,0,-3958441629,2cff2cf58bc445d04be827ce3d76f6ae98761276671c82994e7688b2554815f1,17491876942
2022-11-16T19:29:38Z,PAYMENT RECEIVED,643976192,0,b017f8b0575e7b134fccd7229d538b8b316035504d0923b9b93b6dc81b7ba856,21450318571
2022-11-16T18:22:08Z,PAYMENT RECEIVED,650713273,0,abfd66c064acbc4ab67301767638dceaead876aca0fd41a7c89206995b98402d,20806342379
2022-11-16T16:41:54Z,PAYMENT RECEIVED,659582737,0,d99562cd6905a049ea2e0151c6dacb4c2bf86e99693824978ef6a513c0eb495b,20155629106
2022-11-16T15:47:29Z,PAYMENT RECEIVED,650472222,0,745675d411d3033215921935382d8b64655b8b802aef097598a403602b4a315b,19496046369
2022-11-16T15:38:50Z,PAYMENT RECEIVED,641265052,0,9b1061bfe43618baef1a46dcd05bda853ec413fd48f09a892ebcc173d5e20a8f,18845574147
2022-11-16T15:28:15Z,PAYMENT RECEIVED,648897036,0,5802ff5870cb0eb88eadb4f937922f36eed5360ca4e933518e78600cd0b55fd4,18204309095
2022-11-16T13:39:09Z,PAYMENT RECEIVED,658635656,0,10f7b46a10c1a76773c6653620000f26f331daec60e2023ec1945b19c699bf0e,17555412059
2022-11-16T13:08:57Z,PAYMENT RECEIVED,644539940,0,c556ec046d30a3175c71a19b5723bc467933558f5d1c55727bbe26d74ea8de5f,16896776403
2022-11-16T11:44:35Z,PAYMENT RECEIVED,642390733,0,015d13218863980878a4fd1953aa2ad277667006d9778402cb1b177e3f9844ac,16252236463
2022-11-16T11:42:20Z,PAYMENT RECEIVED,660162532,0,85adccf0808780e5b062f901189cac7392c04cc4800958e6945788ef7617acd7,15609845730
2022-11-16T10:40:28Z,PAYMENT RECEIVED,647917697,0,27ccd2961b7a0ce1b9039cd64cd157442ce75475a147611e4e93bdbe6a01397d,14949683198
2022-11-16T10:19:55Z,PAYMENT RECEIVED,641058522,0,c3d54537623df155d4d87dee32a1a43167cb5bb80e6719ef6da01ed46fa2d088,14301765501
2022-11-16T09:41:21Z,PAYMENT RECEIVED,641287298,0,0a3ed47751739d6e08865a7fcc5ac0e852f127784de60bc2b469b5de53936894,13660706979
2022-11-16T08:58:41Z,PAYMENT RECEIVED,652412312,0,d01e066cce1a7b73d994a8b8af97f07fdae80d617197be43e3ccefc4d69bc71e,13019419681
2022-11-16T08:55:43Z,PAYMENT SENT,0,-5692913439,45247ccb2a9ae0f6289ce70050a4a45e142af28acf473a57007b98f369c1358d,12367007369
2022-11-16T08:02:16Z,PAYMENT RECEIVED,660076051,0,7b66524165c47a0e45d66d2354e936391643b18f0ef14d04be541aabc0623c7f,18059920808
2022-11-16T07:33:51Z,PAYMENT RECEIVED,640726957,0,993b5b433aea22afd2791af3983532ecf22580eb421da5590eeca9373627aa60,17399844757
2022-11-16T06:26:59Z,PAYMENT SENT,0,-7692412869,60713a6c03ccdc428b62ab10d56d76bb9eac7be31a39a1f5d491e4ea46ea49d7,16759117800
2022-11-16T04:56:04Z,PAYMENT RECEIVED,644195439,0,6220960f8b9c78270092b4c78c9651a89133c45468ef49eda1d5249959cb89b2,24451530669
2022-11-16T04:10:51Z,PAYMENT RECEIVED,654840773,0,2494790577807f3f9633b617efad2308e16b0eb962a81ac319ae84562abe8380,23807335230
2022-11-16T03:28:00Z,PAYMENT RECEIVED,642737208,0,00be1755e6683690775b6fdfda273d14660c961ac7922b0cfa7e6b7e778d6acb,23152494457
2022-11-16T02:46:03Z,PAYMENT SENT,0,-1275084029,8edbe2cfdbd29cf15cb0f76dca0006b07d35caa457bfe4e379dd3deb4ff75b69,37412039747
2022-11-16T02:46:03Z,PAYMENT SENT,0,-5261014793,3521cae8f637821e71cb31bf28a3b8af70d01869a7dc2217a7a2dcabbf11cb09,32151024954
2022-11-16T02:46:03Z,PAYMENT SENT,0,-9641267705,1472aafb8ce0731fb8f99643630b06c9b3d235ce55932373252203fc26527f64,22509757249
2022-11-16T01:27:45Z,PAYMENT RECEIVED,647531601,0,dd1dae6576c6c482c0b1d46263a38206713b06d70269ab72db8247cc2a24c72b,38687123776
2022-11-16T01:14:01Z,PAYMENT RECEIVED,643548381,0,1a3fa29906a42189e54376a6d76c63e6f876776e1cda0360d3b601810cfed080,38039592175
2022-11-16T00:53:39Z,PAYMENT RECEIVED,652145774,0,3e39d6cfd154c51798145b665808ad63139c6c71e340aaf3cc31103f50b5aba8,37396043794
2022-11-16T00:27:34Z,PAYMENT RECEIVED,644889891,0,96eeb182d0a13406a30a1a14140172cf53e57063bc51643d376f27ac3732cca2,36743898020
2022-11-16T00:00:35Z,PAYMENT SENT,0,-625216520,4c5a176edb760ff007aaed2e3434023ee94ca162e9b18278db2986cc85af401e,36099008129
2022-11-15T22:40:35Z,PAYMENT RECEIVED,668738958,0,bf8debe631afbd51041e403bd87de95cff3f02da5ca9e3a531633da766e6415e,36724224649
2022-11-15T21:34:11Z,PAYMENT RECEIVED,647128487,0,d3ce0a931c8f2de864370ac54f2ed63aacea09468b71481a23abe7dcef8d17f6,36055485691
2022-11-15T21:18:42Z,PAYMENT RECEIVED,641652182,0,60ff8c2d4fa759d51270322b08d75aa9b4704770e57a54d1937876668dd58906,35408357204
2022-11-15T21:14:47Z,PAYMENT RECEIVED,647854154,0,1ba2aaa4db3a50a8854ebcb78ae14296cc36ac0c63e463a162d06488826b30c9,34766705022
2022-11-15T18:53:48Z,PAYMENT RECEIVED,659902199,0,aec8c3799287255c273b3ef92a1578c4d19a8a6df8b0e41df42b24ae3d816d16,34118850868
2022-11-15T18:37:12Z,PAYMENT RECEIVED,646486522,0,c2fca83f1c37948242eec177afeddd75ac48f1e2c815dcab53795de5b35a74be,33458948669
2022-11-15T17:26:34Z,PAYMENT RECEIVED,661799593,0,f6cf96f3b6d8816dcc1a732866b7275001b676cb883de65959bdfe5ee827d5f2,32812462147
2022-11-15T17:02:56Z,PAYMENT RECEIVED,656385093,0,8e300c5058dc8aca27368bef74f6f479e23362aed813f4721175bccc3d8677c1,32150662554
2022-11-15T16:38:22Z,PAYMENT RECEIVED,646613552,0,5872721e2bb378c01ecfdfb10dcc2362b23398965dd7d136bc34a5d6e4abcc26,31494277461
2022-11-15T16:05:18Z,PAYMENT RECEIVED,659470012,0,43838d84dcc4872188a017fdc3c93d0385d72bd2653af612494bfd4fb50a23a8,30847663909
2022-11-15T15:09:56Z,PAYMENT RECEIVED,650467616,0,0794f9d66d5e769469b00bb24d5ae80f56275a784bf69c79511ad9c499f401c4,30188193897
2022-11-15T14:28:13Z,PAYMENT RECEIVED,653575436,0,5a3af5b0182e129b1a19cc17410d491962d4efec349a987fc9c237767de7580c,29537726281
2022-11-15T13:29:26Z,PAYMENT RECEIVED,640933667,0,fa91b3e58e908f829623fe18c561ad2d810abd90a828de3a76230518878eecf4,28884150845
2022-11-15T13:26:43Z,PAYMENT RECEIVED,639732936,0,212c24589476678826e3b63ca8ccbf01e9f75b24e6aa8fc8fde4b10c7662dd2d,28243217178
2022-11-15T13:22:24Z,PAYMENT RECEIVED,654832670,0,add58c7443094ab9ae07d818316aafe637626818f32d7499b6aad3aafe5dfd1d,27603484242
2022-11-15T13:14:40Z,PAYMENT RECEIVED,650484273,0,07ffcbe29083f3ab73b09dd43965a4aa3ff92c699bb116649b2089f0e5109a60,26948651572
2022-11-15T12:19:21Z,PAYMENT RECEIVED,654393400,0,b292925618cfd6bcf9b1baedd7452736b77e4725a19a0467b033f9316b6a12bc,26298167299
2022-11-15T11:34:05Z,PAYMENT RECEIVED,664325806,0,b3897fe609bbf14fc4ef07720642456d7d97f7cc37306a5b4a9011c8255577c1,25643773899
2022-11-15T10:31:21Z,PAYMENT RECEIVED,653185987,0,066127617e254d959bbc5de246112bcc7303715804e435d30247ee80ce259963,24979448093
2022-11-15T08:25:28Z,PAYMENT RECEIVED,640375763,0,b7ca2959b8f40c82549f3e7fbfc8b0f3056dfb675688f203b350bb35ee2e5b1d,24326262106
2022-11-15T08:23:21Z,PAYMENT SENT,0,-1953855654,f59587cbc911dbb9b749a11611cd39b85ad5827f2bb18bddf5b7cd49b908bf3d,23685886343
2022-11-15T08:12:51Z,PAYMENT RECEIVED,663894717,0,05a53db856af42c07e2341d35eddf8bf6e0ff1147c3331bcef20c72f3df35fb5,25639741997
2022-11-15T07:39:55Z,PAYMENT RECEIVED,650400740,0,101ab5ab54187bf2232bf16f29526e4533a682792454b8583c1ceaaa53615bad,24975847280
2022-11-15T07:30:15Z,PAYMENT RECEIVED,658311540,0,6ba454f47543f1aa3eaaa2f478ac6747d5688a28ec663d1439560eacaf5d8fc3,24325446540
2022-11-15T05:07:58Z,PAYMENT RECEIVED,644412692,0,b45a69165396f5bbca2b7889c8b59b77f6d8b6322ef4f50f312f27be235aceff,23667135000
2022-11-15T04:12:42Z,PAYMENT RECEIVED,642704785,0,a05218a60190ee864dddd924816c4ee1cca2ba13053d546a5ff52f24046eb020,23022722308
2022-11-15T03:52:20Z,PAYMENT RECEIVED,643475027,0,9a751101b9f5ff509b7fc6b34405472af1fac526ebd86a2260297df3ef7cfc64,22380017523
2022-11-15T02:49:14Z,PAYMENT RECEIVED,644644599,0,c3ab0d738f6a45b6a79a847d55a8351158c9fa66a2facbd52d6a24a0080ccbee,21736542496
2022-11-15T02:16:53Z,PAYMENT SENT,0,-7660658028,e9ec519bfecf11746bafaded78c0b8ac6dfabd7def9d706bb4a6e9a512d579b7,21091897897
2022-11-15T01:09:13Z,PAYMENT RECEIVED,648390259,0,088a1d97db0e2f1b54491d481ab40c12ca6b8017f20f3e76bfcd5d3ccf6f48ac,28752555925
2022-11-14T23:47:49Z,PAYMENT RECEIVED,657605662,0,e54e82f3afbb7a47034b7ba79850a89e7da7ab5faaef166ea4479d08ac09db14,28104165666
2022-11-14T23:11:27Z,PAYMENT RECEIVED,664950802,0,49fa9caed75e63332d650dd02c055db4b65cefc6c14e62a88f20373804e52ab8,27446560004
2022-11-14T22:39:04Z,PAYMENT RECEIVED,657553780,0,0dc0f95f0b917055f1ec97d687f30fe6095e1c3c382a27770f0f6c157a918ca5,26781609202
2022-11-14T20:29:08Z,PAYMENT RECEIVED,655111565,0,bd8fcf764aff2a15a37b0278d90d01543eb2b28786b77ff1a24af0cf9c56504d,26124055422
2022-11-14T18:01:07Z,PAYMENT RECEIVED,641679172,0,d0ab533bc70ff28d7858c1199a28b20d369ed359b6d45b3820db389f6930b034,25468943857
2022-11-14T16:20:31Z,PAYMENT RECEIVED,647021846,0,34998a8850d9ae462399834ea39ed9977639831c3f0153b911ba0095ca2200a0,24827264685
2022-11-14T16:06:09Z,PAYMENT RECEIVED,639706710,0,6046ed646cb04ff2c905cb69927da3bb1989e1e36b86bb0b416fb87893dae67c,24180242839
2022-11-14T14:44:35Z,PAYMENT SENT,0,-2598823414,501c828d0a06f6df7b55973b15d10d73ae125e2fd6f37a7ac2a80e01ef241e03,23540536129
2022-11-14T14:12:01Z,PAYMENT RECEIVED,643775890,0,3a133b859e427bd877436aaa7f0a1b2632a8974f7f689f589cf3ce8f76dbf520,26139359543
2022-11-14T13:57:07Z,PAYMENT RECEIVED,635523345,0,9e5b8c4f4a470a368769ba48e596632e2c73f77e2df4e7ad674ac0575cb6c1aa,25495583653
2022-11-14T12:36:11Z,PAYMENT RECEIVED,632288303,0,fc0a89fd9bf6c9a96fda0b4f7904e02827a51c50dfd77764a36a11cca7a4a0a6,24860060308
2022-11-14T12:30:22Z,PAYMENT SENT,0,-1282831067,2b918565378cc3bc9ce8d1308c19fbe04f9cca1f0dde3b9bffa143f4030ae7b4,24227772005
2022-11-14T12:11:24Z,PAYMENT RECEIVED,640882225,0,2d95944625ff0a8be2fc3c7295bb7da1ef5e672c63b3efc40bf56b2c1b7884b6,25510603072
2022-11-14T12:10:58Z,PAYMENT RECEIVED,658326564,0,c749f4c9e596a32e5d1536e3134564f5f82889a9617cdd9071a921513bde2b72,24869720847
2022-11-14T11:05:07Z,PAYMENT RECEIVED,640832052,0,0777df8969ab918a0c056425857de50b3eeaeed3367e87712933010790299493,24211394283
2022-11-14T10:52:55Z,PAYMENT RECEIVED,652573339,0,d3582f8fb2cbcdef0d552c732fc0bb99536bbc32ef4222404f4e7aca9a8ad13b,24860995765
2022-11-14T10:52:55Z,PAYMENT SENT,0,-1290433534,1a9b53a0aa83f85c35b085f56891facbf99cd007b9dd54489c392e5a80f568ca,23570562231
2022-11-14T09:41:12Z,PAYMENT RECEIVED,636610509,0,832104af3a0251fbfe0c33edea1834de2a6f33f72d8f9d84cc32619337bffed2,24208422426
2022-11-14T09:31:12Z,PAYMENT RECEIVED,642955751,0,42276fbc5fbcc55641d6737355589847f8c6a4966c80db50a4aee65cffc2ca2e,23571811917
2022-11-14T09:22:01Z,PAYMENT RECEIVED,640739934,0,4a8a03ef2e741be2114414fbc90a7a2d2de7af47030aa61781a6fa36874d4f4e,22928856166
2022-11-14T08:51:59Z,PAYMENT SENT,0,-2524222631,d2dc090c9a1ea1ca9c1d19188352535acdc0d7fd7d908a6e3ca9c4345e398f4e,22288116232
2022-11-14T07:12:33Z,PAYMENT RECEIVED,627324816,0,0fd55e160159d21d88e57a0a16abe2a0bf60b969a2aa7a916f092662623f8987,24812338863
2022-11-14T06:49:31Z,PAYMENT RECEIVED,639956901,0,83c47e7005206b4092fe2d148bb5abfeb8c1c8961c42626bd735d7c1d6c2e920,24185014047
2022-11-14T06:32:36Z,PAYMENT RECEIVED,631890356,0,2f90549bed301e997d8a2c1a384c8e8598c401f98b185d0d7fe8088a816cfd5c,23545057146
2022-11-14T06:15:49Z,PAYMENT RECEIVED,627228530,0,2cfba735f747407a79a49a9056d5a7fa86b2ea9e24d2494355829e2a4eda9a07,22913166790
2022-11-14T06:13:12Z,PAYMENT SENT,0,-645278949,0a8a90e50ee50e30f6797041d90bc71eb8524a5b2d5ce8ca1cb834d3e4d07c3c,22285938260
2022-11-14T06:02:51Z,PAYMENT RECEIVED,626828657,0,8d038a1e2be564e135ec9bcfe0c885e197160e39f3cc02d50c446c13eb0c3814,22931217209
2022-11-14T06:02:11Z,PAYMENT RECEIVED,642669850,0,8fb706ec9faf62d8a8447a9f5b205886f84f1194f49873a039cf1441f9d6bfe5,22304388552
2022-11-14T05:50:17Z,PAYMENT RECEIVED,627171938,0,6ea230f2d23c3fd7ad664463b69abfb0d415de04c7a3fcdc539c1e78f65ae0db,21661718702
2022-11-14T05:47:36Z,PAYMENT RECEIVED,630343618,0,c288347ebfe224f8af916bc3c22e408bca3402f3bb2959d846a60bd796f821c6,21034546764
2022-11-14T05:30:05Z,PAYMENT RECEIVED,638473520,0,f3280b5fe232ce150a4aa0161e5927cdde4aa21bf5e9a7c38ff523442d294dc8,20404203146
2022-11-14T05:17:35Z,PAYMENT RECEIVED,629890424,0,9336b4e99e06ed0792a162cb5d9bb8abb650127281e5d57bcf15b50bedb227ae,19765729626
2022-11-14T04:55:01Z,PAYMENT RECEIVED,630944344,0,660aed496ee33f132fc4e1b1052c41cfb0b5ab41f3c9ae1fff9f8757eb28c986,19135839202
2022-11-14T02:56:06Z,PAYMENT RECEIVED,654618868,0,e9d8ac0ed6dcae63b646a5a8d39226bfcca3ff97fa641ca92d6df67281f46006,30018566793
2022-11-14T02:56:06Z,PAYMENT SENT,0,-631203831,fc9639b72005a5d8757af01ea7689c7cf821798dedc238cb0b6cf8d9da1c1c92,29387362962
2022-11-14T02:56:06Z,PAYMENT SENT,0,-10882468104,6f2f415bf9913bbc7341c83392f9d8ef7b9032e270f53730b5fc17258df76f68,18504894858
2022-11-14T01:07:21Z,PAYMENT RECEIVED,656086713,0,1da579a9e5c91e8349a5f5c78514cd2c81bfedb42ac1a2bf9250d29988ea46e7,29363947925
2022-11-13T23:23:23Z,PAYMENT RECEIVED,639297062,0,daa10e2c055bd0ec6330f66f29ee4616b7d7517cd86b59897f1a50d3406ff447,28707861212
2022-11-13T22:57:54Z,PAYMENT SENT,0,-625000000,86f2093023af6b58943f82d51447f45ed17b8beabd49509ca532ee4e310cab0b,28068564150
2022-11-13T21:40:58Z,PAYMENT RECEIVED,648433405,0,df8fa4676ae9c6cc7ab819c5132a64982def46de934e65456b1500b6340b737d,28693564150
2022-11-13T21:23:45Z,PAYMENT RECEIVED,650464702,0,a9a4760a67da95329c42349b2416ca76be2722930577fc6e585d853605a767b3,28045130745
2022-11-13T20:11:20Z,PAYMENT RECEIVED,654876052,0,736d4e1c6d906fd9bf7ee60a0b3ffb31805af83e3bf2dd8b20c7d0d438cb3ed3,27394666043
2022-11-13T19:31:20Z,PAYMENT RECEIVED,646821035,0,4a0c8f156a45a69729bf5dff4b83e70716b558f2bf4743018b6ea9bdcd76ade2,26739789991
2022-11-13T19:21:43Z,PAYMENT RECEIVED,650782902,0,29d5592f49c1ee40f4593545c2bd5c72b460e9beaba664fb4b4a56f76fa06165,26092968956
2022-11-13T18:02:35Z,PAYMENT RECEIVED,630898957,0,2e13925e0a1d26bf87d9bee1a72b1d5fd46edd1a9cf30357f7ab6a29143ae213,25442186054
2022-11-13T18:02:15Z,PAYMENT RECEIVED,646343425,0,19be3df807d076803bb39811ef4b8a5edfd89bb36a709862f769299880bc80ea,24811287097
2022-11-13T17:26:03Z,PAYMENT RECEIVED,629591413,0,40f1f2361da902605ca5b3623934525db5a8398d6c8c3b340db594fb04acb7ad,24164943672
2022-11-13T17:21:39Z,PAYMENT RECEIVED,625599362,0,bad64fdf87f6c0c0831c30e7941e5d13cae16b81ee9bed99ce257617994112b7,23535352259
2022-11-13T17:08:33Z,PAYMENT RECEIVED,631636145,0,cb667a0e6d4b29711025925a3773cc6988380cd3a44a4ac3c1e0b3dc69f0eec1,22909752897
2022-11-13T16:34:41Z,PAYMENT RECEIVED,645720616,0,b6671e327971da35e750cf27447c0ca5196337d615d8149d45eca8dc75bf990f,22278116752
2022-11-13T16:14:37Z,PAYMENT RECEIVED,625216520,0,0a62513f8ec8bdd90e55b63a5bc9eba232f62205cb1e38f8fbec09276a7b3594,21632396136
2022-11-13T16:00:12Z,PAYMENT RECEIVED,639241969,0,ce71e5be0dceded86638e7eca00e6957ac6ad0da15af63c6162dd33deaba9cb2,21007179616
2022-11-13T15:47:12Z,PAYMENT RECEIVED,651191565,0,a9b57e44f3c755c3c54f10d43a88091d6e22446b6ab965fad923b2561a345353,20367937647
2022-11-13T14:38:16Z,PAYMENT RECEIVED,637110451,0,83982fa97331016021b1ef56ca9248b8e7e0354132a96b965f00d67f4d035927,19716746082
2022-11-13T14:26:30Z,PAYMENT RECEIVED,631569870,0,2f4b94ea4e4854f35996751d405d07161e9fa45e59f75da13aef49bb3caa3b0e,19079635631
2022-11-13T14:07:52Z,PAYMENT RECEIVED,630051082,0,1b2f2069c43e9637c4cdf45577cdd8a9ff5bedc69c5f28fee11599d899c5c817,18448065761
2022-11-13T12:54:29Z,PAYMENT RECEIVED,627431172,0,b3e19f037171069e269efcb3cf7dab7ae6237f01aab7a177249d6a3817a7b5c7,17818014679
2022-11-13T12:30:30Z,PAYMENT RECEIVED,631685755,0,acb52b0582362109e6fc8258d790d96e998921689626bdc64b48f2425e75a2d0,17190583507
2022-11-13T12:19:09Z,PAYMENT RECEIVED,645278949,0,68c88e91f2217570f49dd0d714000c8a476dd3e8291fcd587e732221cdcd568a,16558897752
2022-11-13T12:00:11Z,PAYMENT RECEIVED,630205975,0,37741317b5d2c45a4e8ca4a8f33998e21ec520ad37f281ec82e9c428fca33a1d,15913618803
2022-11-13T08:40:18Z,PAYMENT RECEIVED,627285912,0,9d7ddf6e0ddd8f3b40b69ddef977dd5db8275248e492ff76ca7a326abb582431,15283412828
2022-11-13T07:21:54Z,PAYMENT RECEIVED,632286446,0,e1b02ab46f2064315ce37a36369d0667fc4709a0f2acd3307c5e57a0189afbcb,14656126916
2022-11-13T07:03:51Z,PAYMENT RECEIVED,630707997,0,4b51f0d125005f891266d3daa66afb60a7b6d2c6f4eda4e7a08bb20702e23418,14023840470
2022-11-13T06:56:27Z,PAYMENT RECEIVED,634807009,0,86802071a4f9383d8ab6bf64b134b2195468d1dc5bdb1b7c4c2597c7b35611f7,13393132473
2022-11-13T06:14:26Z,PAYMENT RECEIVED,628429362,0,c749a1d85bb277b777e8254f930247645ff0827e0bcc6f1fa9fde4975b2d7919,12758325464
2022-11-13T05:55:29Z,PAYMENT RECEIVED,627774071,0,5152532b64e3d662f5bd3b026cc6cf1459aa5487dbae30730883204ca19b3936,12129896102
2022-11-13T05:55:23Z,PAYMENT RECEIVED,635762802,0,fdaca362a86e52c8e8c71d2cf700954e04c4d6191472711817655b4815876e32,11502122031
2022-11-13T02:13:45Z,PAYMENT SENT,0,-9427101304,ae60c4b000969cf46d431ec3ae5d97d2d71707389d0a0232df7e26308dcb60f7,10866359229
2022-11-13T02:08:31Z,PAYMENT RECEIVED,640051811,0,9f3ed6d10d646d4c520b43e3ae10cab7d31eabecff7c64867b78f807bb484541,20293460533
2022-11-13T01:57:17Z,PAYMENT SENT,0,-5182202879,326a91de527464a6ff22be4b689bdd16d50a5945f64062a21b94b713644f90f4,29170712604
2022-11-13T01:57:17Z,PAYMENT SENT,0,-9517303882,6ddfab99083d79d31b3450a97348db86f804a0914d9e104d6ebab265185c875b,19653408722
2022-11-13T01:22:30Z,PAYMENT RECEIVED,646765605,0,c3ab77830fce63b5151e8b41865a85384f5dcc3f9e98fb7f69a88089a990d9a0,34352915483
2022-11-12T22:24:25Z,PAYMENT RECEIVED,642304002,0,f31374e5a3de17f51549ced051d3940440820ec9314aa4745042f43d4bba70ba,33706149878
2022-11-12T22:21:48Z,PAYMENT RECEIVED,625000000,0,bc19dcb8e63ca5e229258ab4e8534af80506e06222f61438c87792274c364e01,33063845876
2022-11-12T21:09:31Z,PAYMENT RECEIVED,642210088,0,daeb21486711d2a7ae5e0ab59653a36721a270f61f8a8744e656a8f86148df9d,32438845876
2022-11-12T20:18:21Z,PAYMENT RECEIVED,650042152,0,2abf315a5c858dca043b48d9cf0a3e4d1b7293a7dedffc7ffbb43961ef8edc09,31796635788
2022-11-12T19:03:54Z,PAYMENT RECEIVED,635586462,0,b8df8b6f45274d4223e4d3841c8eab243dfcc201a2550cac78bb4ffc7a307213,31146593636
2022-11-12T18:26:43Z,PAYMENT RECEIVED,639115353,0,78e19a4122f1a34b8983fc388a9544f812cc7d63b5158d8481371d3c40115404,30511007174
2022-11-12T17:52:37Z,PAYMENT RECEIVED,637639074,0,597c74cbc1ea5962df246f27ba048e8558f47ecf91fa6852303b2acdc05ee3ae,29871891821
2022-11-12T17:04:07Z,PAYMENT RECEIVED,640770472,0,f40dd23b822c638553ead4a80ab9dac201e503b86037deacda9d9fd9f62de609,29234252747
2022-11-12T16:00:31Z,PAYMENT RECEIVED,642782126,0,7baaf086e3108bf8f5452223be49d43c4f3e83f14e923c4fdbb39061e44b3748,28593482275
2022-11-12T14:12:40Z,PAYMENT RECEIVED,631203831,0,e47c0b80f936d51375e7f422b08dd3ac9aafd76502c98d4698aa213480ba8512,27950700149
2022-11-12T14:12:32Z,PAYMENT RECEIVED,648823522,0,6d8ed77e1528f41f77107c268c2784cd5e40bf98961d9b3a0250606ad1b1bdd4,27319496318
2022-11-12T12:02:16Z,PAYMENT RECEIVED,638091458,0,8cb149d5627db8fa791e75ead3c178574ec231bd260e1a77566b172ba320f120,26670672796
2022-11-12T11:45:42Z,PAYMENT RECEIVED,630259009,0,51d043ac2d17a1335808d9544344b678f86bbe47e43d025067cc2db849d4c5f0,26032581338
2022-11-12T11:40:24Z,PAYMENT RECEIVED,641204035,0,ba90e31c6e15de963ae0c05778b91b2acb830e62abca077e3e72d3fa30db689c,25402322329
2022-11-12T10:46:18Z,PAYMENT RECEIVED,634225687,0,1170821effdb7f9dd29fa823525563afa7f910d78bd1b92ea9c953f36820f341,24761118294
2022-11-12T09:21:17Z,PAYMENT RECEIVED,634157871,0,8fc3186d61cb21eb70ee03d83494ffa753ccb31cfc6a3152f36e239c9b3fe35b,24126892607
2022-11-12T08:52:19Z,PAYMENT RECEIVED,630637119,0,c88d5ecb6d35d0671c8621e5ef7555f3e05258c1f61b3ff59c52b4e630382991,23492734736
2022-11-12T08:45:31Z,PAYMENT RECEIVED,625934215,0,007d251f8a35519a6bb0f90200b9ed8a3b9a40b3378a131b1601b410642ef833,22862097617
2022-11-12T08:20:04Z,PAYMENT RECEIVED,628127988,0,1520105ebbf42c8ef04194db40a8305dbd9cf470ac7035a71ba050ad5340b625,22236163402
2022-11-12T08:11:29Z,PAYMENT RECEIVED,649543372,0,0ee50a8de8a5cf33bc92425d751d4fba70c71c346ac7a38f2b828f4319cbee7a,21608035414
2022-11-12T07:47:40Z,PAYMENT RECEIVED,629270952,0,6cbba0d03b68189fcffd7f59c46707c66075244e6ccfa37bdcf31e5d9acf04c2,20958492042
2022-11-12T07:26:10Z,PAYMENT RECEIVED,632495520,0,7f66f4bc7986df6a89b4d9046c3d8bc2e7fbbeae7728fec2f12c0ad253253a6f,20329221090
2022-11-12T05:52:01Z,PAYMENT RECEIVED,625706090,0,5807cc1dd78af0154049dbd614cbfd30f8f4897ab4144ecd92809ed489c86ee4,19696725570
2022-11-12T05:08:34Z,PAYMENT RECEIVED,649476507,0,44c429336f24a982fdc4d3bde14c3dc1f23daae03d4dbfa9b7afe2ad533b3d40,19071019480
2022-11-12T04:15:51Z,PAYMENT RECEIVED,630023759,0,e3f65568cf3475a343061bae04a719927dd8035be044db26dfc321bf453945b7,18421542973
2022-11-12T02:54:28Z,PAYMENT RECEIVED,635185199,0,000053983dcf4f9ad874fb914d92d287624d90ba8950fb253442123399c71140,17791519214
2022-11-12T02:05:22Z,PAYMENT SENT,0,-7124009977,64171357925a3fa41ef98764142f180a2632729dd15922bd03d6e4880cf69cf2,17156334015
2022-11-12T01:57:35Z,PAYMENT RECEIVED,626344222,0,a939eb5603995d330c6bfe2656e312d590c7a1e83852dd9ce48e8286d6ce0987,24280343992
2022-11-12T01:28:17Z,PAYMENT RECEIVED,629923255,0,32fd185734a676b9473b0ce823c04e316aa3f303fe1becd7dc7f2f2c47b25e2f,23653999770
2022-11-12T00:52:20Z,PAYMENT RECEIVED,628845866,0,41ff956dcca710f6c3ad9c25d89e4a0b850b35c29b2db81be51ce6c528b0dd74,23024076515
2022-11-12T00:02:52Z,PAYMENT RECEIVED,632005417,0,4d8a2812249d31caef843ab040842ecbfd3ad752c27f1cbc8a27c4aa40925203,22395230649
2022-11-11T23:43:03Z,PAYMENT RECEIVED,641655812,0,0a14142440a6e7f90f03cf7c2e8a9ae8100dd54f0f02eb7c9145ca36b07319b5,21763225232
2022-11-11T21:52:55Z,PAYMENT RECEIVED,641131651,0,009daeb21500db02f267bfe67a0f503353a24d8ecf03fec50040528a4c3275ad,21121569420
2022-11-11T21:12:15Z,PAYMENT RECEIVED,626207740,0,c9f49bb62993c9ea891abc896536c23a7fb5030b0dc195b3d73ca8e4cc9bd77e,20480437769
2022-11-11T21:11:15Z,PAYMENT RECEIVED,631239138,0,e31b244e3835f671d6b3ab9fafbecd51d9ed1e6e181bae84580f63dacca6a05c,19854230029
2022-11-11T21:07:57Z,PAYMENT RECEIVED,635357483,0,7a91aa8559efdbad9a9a346ae20a3003f958142b3cf1ad6c45547bd7ecc2029a,19222990891
2022-11-11T21:00:49Z,PAYMENT RECEIVED,632599670,0,232da807b3d15470bdf10113327e1991855a2bf4119a26603cb7907e79b34883,18587633408
2022-11-11T20:31:25Z,PAYMENT RECEIVED,640316753,0,a97966156fcb109d0b54c98ef8519448c5082122ad717a1ec2e540e6c7bc6065,17955033738
2022-11-11T19:59:42Z,PAYMENT RECEIVED,647030915,0,5f01595d22b9eb7b9f225aa6e197ac504f85b65f8bfe4378d4c5cd46a7386283,17314716985
2022-11-11T19:45:50Z,PAYMENT RECEIVED,636339354,0,1ee4d1f460aa9257a51e8a34591cd37452e45d82609da7da6364bc224f4242ca,16667686070
2022-11-11T18:45:25Z,PAYMENT RECEIVED,635063714,0,62dbdc1e05130df31cd0cdd0b7ecfe1ccdcb5f271996930475ba8e892ccc0eb9,16031346716
2022-11-11T18:41:49Z,PAYMENT RECEIVED,659367855,0,d554192df7158d92229efd4c9890f8f78c6d48fdcc68983768d63062c0a95ff2,15396283002
2022-11-11T17:05:55Z,PAYMENT SENT,0,-649080739,92ff296144ea3851863d662a62cb5c6c50e8390070a643977a7b4d877d44cbde,16047131460
2022-11-11T17:05:55Z,PAYMENT SENT,0,-1310216313,5a16b9265af040d06df6c30bba88c49bc57446409f4056db49c2e06e31304438,14736915147
2022-11-11T14:16:05Z,PAYMENT RECEIVED,647990658,0,afdfa3c5c37e41337688d191eb0c43e1f07acf7a891f90491fd15a1642cf1a2d,16696212199
2022-11-11T14:02:56Z,PAYMENT RECEIVED,646006109,0,c1079a974c33879d77c64b0cb82a1a1f713d0f2a15d750a173f4ab437b4df0c0,16048221541
2022-11-11T12:42:08Z,PAYMENT RECEIVED,632424485,0,3dac675767ec8cbbe0d6e24bd05778a61c6c011cfcd982be79a34c94dd12fddc,15402215432
2022-11-11T12:18:00Z,PAYMENT SENT,0,-651087673,4045ce399129298923fde9e3d7da985d3dbc29e128e36c675a96fbe5d0cb7c57,14769790947
2022-11-11T10:28:52Z,PAYMENT RECEIVED,649256301,0,41e72c43036e4a5d166ea87863b7fb8b5f0e9a4546f04477261e70b556fa222a,15420878620
2022-11-11T10:08:30Z,PAYMENT SENT,0,-1932928056,96e466c76daab348f0436e9b3f8d45ea2a63a7d98c72323e7bc7b0897dea22bd,14771622319
2022-11-11T09:34:17Z,PAYMENT RECEIVED,640237716,0,22d440c2b8921b4f0494d3bd94f4e84cfc5faaf1e5e133939e6837c7a7f024aa,16704550375
2022-11-11T08:22:58Z,PAYMENT RECEIVED,625667182,0,6a947d90199c2107aad54736a101b8bedb9467033db5e2c119130671863d2c85,16064312659
2022-11-11T07:27:42Z,PAYMENT RECEIVED,630067661,0,9ac3f001468669323929df194750b399403fa513a622635fa9ae059583cc63be,15438645477
2022-11-11T07:06:48Z,PAYMENT RECEIVED,636807677,0,289e1c413c12e6df0cf976d61e62995632353eb938d802d45f6b8157d6dea55a,14808577816
2022-11-11T05:18:10Z,PAYMENT RECEIVED,634714372,0,881ae28735d81f5e8748999f2df85972336f875e6f6a7a3658e2b482ab1c13ab,14171770139
2022-11-11T04:31:46Z,PAYMENT RECEIVED,647550650,0,c71a8e6d7243eb35ba0382b01d8347c153119e47039e69d034f4e5f67c16a1ee,13537055767
2022-11-11T03:55:55Z,PAYMENT SENT,0,-10148694914,ef7f261ac30a3d7fed65c2fa48ea5c0bd705935037e9238f7dadf338d8d47c12,12889505117
2022-11-11T02:35:11Z,PAYMENT SENT,0,-7140890043,e741013d0f03d0267d8ed4ee083435f999109cee401562dca283aa85a5f0cf0e,23038200031
2022-11-11T02:13:54Z,PAYMENT RECEIVED,628912951,0,aaef29f05dd2d46989fb1b99b418197f1f70c4e1e12c6b55578c59236ba10cff,30179090074
2022-11-11T02:10:56Z,PAYMENT RECEIVED,642623306,0,507931d3a5ee90a8558256fd3edecacbdf9df3117f787357266edb7ad685bb06,29550177123
2022-11-11T01:45:45Z,PAYMENT RECEIVED,657997777,0,17dc0f8f9ae038595154f06ce551183d346fb7f06822d94a9caf8ab5e088282a,28907553817
2022-11-10T23:22:32Z,PAYMENT RECEIVED,634835948,0,0670c9a76ab32f95ad8432621d2aebd1610181e509a29f76774bff742ae4a66f,28249556040
2022-11-10T22:46:42Z,PAYMENT RECEIVED,664015433,0,fc8a5ea984eb6103aef18202b17482ead476a1ffe56ad2fba5ac2be04ddd563e,27614720092
2022-11-10T21:40:47Z,PAYMENT RECEIVED,627274433,0,e3de3000550a731178c6ea119c50ce46feadc4b4e78595d1e2bab84d3edda6f7,26950704659
2022-11-10T21:40:24Z,PAYMENT RECEIVED,637547423,0,40528c18e9f98fb5e80324bb2048e4239ba0a8204f88cdd6c4d0090b72c12555,26323430226
2022-11-10T21:28:53Z,PAYMENT RECEIVED,658728539,0,3174254e7445677ce813f497caa3435dad665219cafc107ebc4d81a46e2b39f0,25685882803
2022-11-10T19:29:42Z,PAYMENT RECEIVED,652135076,0,3652b4d4ccd737cd8aa0f9be15efd66f1f94c568a5d53c3166d4d45810ac9a75,25027154264
2022-11-10T16:54:36Z,PAYMENT RECEIVED,658081237,0,2dc0b404b81214d9ba36f123bfb3ba4889a9d7fc65a7dd5681eb700375ee1d11,24375019188
2022-11-10T16:24:34Z,PAYMENT RECEIVED,642721081,0,cf2dd00f975acc8bde3cb5a9d9afad641930bf533e81634b5d2f9c56222b7291,23716937951
2022-11-10T16:20:18Z,PAYMENT RECEIVED,649080739,0,cf9c647915e9ca0b61d95fe102c891ce535b3e6760dc43d1133eb58066ef8e9a,23074216870
2022-11-10T15:04:29Z,PAYMENT RECEIVED,651087673,0,31d4b2b49041699d6fd60f93120506bc56093f214a1122bf53fb7cf73f84df51,22425136131
2022-11-10T14:10:29Z,PAYMENT RECEIVED,647088675,0,2ec3a16b0c1516106ef3ed8508c30a06449db7390334b483fd8174067b52e66d,21774048458
2022-11-10T13:44:49Z,PAYMENT RECEIVED,641656391,0,5e4ca13042e4eb5535ca474b0f9addd44de682c27f9e545e039c330b84cd70a8,21126959783
2022-11-10T13:19:19Z,PAYMENT RECEIVED,642284117,0,59529b3000e181864ed1263be0039e036cd339366cf9d1fe2013813b63a8696c,20485303392
2022-11-10T12:26:55Z,PAYMENT RECEIVED,635241575,0,92b18b1ab9a7857a7dbc42b11415ba98d2fe1fa6dc5656d61b77e083b2c20484,19843019275
2022-11-10T12:24:56Z,PAYMENT SENT,0,-630927574,2f3cdfbb27ea575a95c3f81e5e82b77a29db98bf81d647d0ad590c2d03115a35,19207777700
2022-11-10T10:12:31Z,PAYMENT RECEIVED,643555264,0,25e0575315794a667a4b327c1501fe8526f851b6f72b5bb08d480219444bd8a1,19838705274
2022-11-10T10:02:37Z,PAYMENT RECEIVED,641675360,0,0e4b17f0071c4bdc665f3e94b11fcf3a07ea7891d14fd539f19b40c929c08ee0,19195150010
2022-11-10T09:46:28Z,PAYMENT RECEIVED,632677577,0,30887d628d7e1d8386e96ae8668dd85c7bb7a8798481d6f8fb544bb1458ebfa1,18553474650
2022-11-10T09:39:31Z,PAYMENT RECEIVED,639231924,0,66bbd7890b61790236877d743d206a4925b76c84d61eded9a12e6d18b08c5bb1,17920797073
2022-11-10T09:02:21Z,PAYMENT RECEIVED,625642549,0,c6ab80c420ec1786c640f83192d1ec1d8ed80388907e6c602388739b685c8080,17281565149
2022-11-10T08:02:11Z,PAYMENT RECEIVED,653090961,0,fd454506e9c335a0d34d1edf7e168ec81387e526b4aa1c16da12510e5ab7f1b4,16655922600
2022-11-10T07:15:31Z,PAYMENT RECEIVED,625592595,0,8dde40a6b39972af21ca6ba6f70e0c5feb77c437d78f6c794c33c425397bd007,16002831639
2022-11-10T07:15:12Z,PAYMENT RECEIVED,627414531,0,b16abeb97b940f62416a36df1e34124c60e2ef77e43ad56ddf1fb2b9fa122669,15377239044
2022-11-10T07:08:21Z,PAYMENT RECEIVED,640805539,0,db413bde5793a25157e3830701ec66fc2de9194e787a9fbe91ab0d1336b1db1c,14749824513
2022-11-10T06:26:23Z,PAYMENT SENT,0,-4445572381,a806327881b06e43fdd32f83dab2f4f7667f67943e7e252881f96ae652a859ce,14109018974
2022-11-10T05:20:55Z,PAYMENT RECEIVED,637003478,0,fd8f96c958ff9b69c749cd3b1209e1134f0055209c4adc378c9699b122abf1ce,18554591355
2022-11-10T05:02:17Z,PAYMENT RECEIVED,625463202,0,d06f22efdf4c62c8817d99eb315254b9bfe08751f9e4e80643d611e7f2a8da50,17917587877
2022-11-10T04:54:28Z,PAYMENT RECEIVED,627983026,0,92bbb052d1fb736809b2e5208cad314df6b2a0dd10adc494803300b82dea0d81,17292124675
2022-11-10T04:53:02Z,PAYMENT SENT,0,-1952342287,122f286e03ab50b2beeddf9abd1690a196295b6cb29d94690e795717146e6d96,16664141649
2022-11-10T04:17:12Z,PAYMENT RECEIVED,630806659,0,64c09f97cbd1d2b57a959a3bb8fba89fa3e24b39e8ee8d74bcf7f9a05f86afd6,18616483936
2022-11-10T04:10:37Z,PAYMENT RECEIVED,642337511,0,01604f4d7d2b3e7542c3d70dd8a5d9ed43675b269d159139fed9b4e1a8b8fee7,17985677277
2022-11-10T04:00:20Z,PAYMENT RECEIVED,643371608,0,24d463b8467960d0fc05e2e39c055ff90adaf043ab862ab4052edfba335a6d11,17343339766
2022-11-10T03:28:14Z,PAYMENT RECEIVED,629839215,0,73b82c9733cd19535448e58c25233ab0dc57ccd7df423e5dd58bb1f5260ae671,16699968158
2022-11-10T03:10:32Z,PAYMENT RECEIVED,657495255,0,d3c35e8b0fa9eb1603e84f28ae83bb113e5c639dd1c19f7e3d4d7511cd137345,16070128943
2022-11-10T02:25:54Z,PAYMENT RECEIVED,639448636,0,026e6b8d4135f4533862d48f027abab916d0b6e0f80c41c0256f40cc76146c85,15412633688
2022-11-10T02:14:57Z,PAYMENT RECEIVED,645376510,0,eb802e6f691fb9616e02f057fbb998a04d18e73e5e7319bcd88bd73c23cd0446,14773185052
2022-11-10T02:03:38Z,PAYMENT SENT,0,-3838589875,be102d4a80c239e09e00e45cbd32d2071a0e2ecd7e646dccaf58061ca3883740,14761993183
2022-11-10T02:03:38Z,PAYMENT SENT,0,-634184641,7a0207b4429a5853972ec330bcf1313ffcde138c0f2337ec5316035738ae8d45,14127808542
2022-11-10T01:17:14Z,PAYMENT RECEIVED,638344623,0,645ad7d416749447436f2c9233381b5ad2beff7a37f1ce91f820baa7b8d97233,18600583058
2022-11-10T01:16:52Z,PAYMENT SENT,0,-642474152,1858e70fa4608e540323d6b0e568b238e1db7b8518a8f9cd2430c9e8181e3f1e,17962238435
2022-11-10T00:45:26Z,PAYMENT SENT,0,-653268483,c5e7c1f5896bed2fd09e986269b0c29e5d503729438e23c49ede7955e8244f38,18604712587
2022-11-10T00:33:42Z,PAYMENT SENT,0,-630008043,ec120046f56c5737d02368d0a3ef9262708db3e0a23a04d2b75f0c910c196eae,19257981070
2022-11-09T23:58:49Z,PAYMENT RECEIVED,641986359,0,4679d3c2415fedf51befeb9258a724c66626c8db637261d1eec25013719ee2f6,19887989113
2022-11-09T23:53:25Z,PAYMENT RECEIVED,644392693,0,d4e2e6fe7e6630644301ac9e19aeb54603decf8055b1590a681f68f49f3a0406,19246002754
2022-11-09T23:45:37Z,PAYMENT RECEIVED,656825120,0,77cd9d3ab6410a894733ce2aababb511bc85b9d37f05159d2eb83dd0c13e7e57,18601610061
2022-11-09T23:06:52Z,PAYMENT RECEIVED,647869202,0,42b1ed86c35c15e05a1f50a57cf345fdd748925f9d625c5f421f4e28abac2be1,17944784941
2022-11-09T20:21:22Z,PAYMENT SENT,0,-630756438,de32d18c8b2ce01d3b1330ef21c6c2f4eef277b1fb97e0c6a30e5b749149778e,17296915739
2022-11-09T19:40:47Z,PAYMENT SENT,0,-2542113741,d9adabba73ef187a4789bb244cd78e9c3c6fd46d25c0317f61fc8ac5a203849a,17927672177
2022-11-09T19:24:04Z,PAYMENT RECEIVED,641440624,0,079caeddede6ba9136d41a91e1b44f0966789f6b44605ff73fdd604594e44448,20469785918
2022-11-09T19:23:06Z,PAYMENT RECEIVED,650934659,0,c6fdcf112f9a5bb262046d8cf17b4dbc6c016f0f504a32f411f00f5a4a92899f,19828345294
2022-11-09T18:55:18Z,PAYMENT RECEIVED,646595142,0,8be7b31fb1b799436c8d3bce950482a69a8f1dc95abad636ad1c8d1bf1cf8874,19177410635
2022-11-09T18:50:15Z,PAYMENT RECEIVED,652601382,0,b35fae61f792efee00e1aeefe18f62f917cf0a93298078ad59e94c51b48f3f6b,18530815493
2022-11-09T17:55:29Z,PAYMENT SENT,0,-2521870901,5b89c2dc04ece1bfedf0bde79af4eb258e0531b4bcf48674406994c9b44bf186,17878214111
2022-11-09T16:45:22Z,PAYMENT RECEIVED,639766497,0,7aa8325cf94ecee6ac06e44233809dfc445add6adba741325b4d05c07ece2a5f,20400085012
2022-11-09T15:31:33Z,PAYMENT RECEIVED,637925457,0,ae2fcfb68fa6d889a58159b5f761e1609b871e8bb170775585f9834332cd7512,19760318515
2022-11-09T14:58:18Z,PAYMENT SENT,0,-3852588658,e4c7562ef29d2e6d94fe82c3e308546f5c548f07d5f719103a1b70263cb148d4,19122393058
2022-11-09T14:41:31Z,PAYMENT RECEIVED,630927574,0,5f22255dc46d189c02d0e937f18f2ed2490bb93274f2ff622fd72408d0b5ed27,22974981716
2022-11-09T14:14:43Z,PAYMENT RECEIVED,627724415,0,0450019f5888378077b4f99cb6d755f8f8af4675c5457fc8edcfedd8cc9bee80,22344054142
2022-11-09T13:33:28Z,PAYMENT RECEIVED,648926353,0,2a2124ce71b20ee1f74b8bca2e4d3494295e2e124cd8cd24a3fee5d3b0551485,21716329727
2022-11-09T12:50:00Z,PAYMENT RECEIVED,625754183,0,ee474c16875b8194743cd8a88603f7b50e698fcffe5bb4c0df07c917905ff014,21067403374
2022-11-09T12:49:41Z,PAYMENT RECEIVED,629583089,0,a6870ddb40d816196bd59bdcef4d4a091f8ac74b5ffbbe1f692fe0c70e3f71b6,20441649191
2022-11-09T12:44:05Z,PAYMENT RECEIVED,633438668,0,f156003057fe4a416ac23ac686f954af3179624a96c4829e9529079ae5e2e74b,19812066102
2022-11-09T12:13:12Z,PAYMENT RECEIVED,643046218,0,23f2113e69b441113170f6df2715ac9dcf7d11f8848981ee1320e15efdfd064d,19178627434
2022-11-09T12:03:57Z,PAYMENT RECEIVED,644579573,0,d41681cde60f7e62c76a7aa42317d27910b2b94f1f3fb55bae6d0d8a059786ca,18535581216
2022-11-09T11:39:09Z,PAYMENT RECEIVED,637099455,0,809468d8e007b8dfea312f1699b000f4d5dcc093d8389c48290c397cdf6c9f86,17891001643
2022-11-09T11:33:37Z,PAYMENT RECEIVED,652915116,0,359c9733c561d7d8c5aa7c363636d3c20a1b3bc12a6bc344a24605fd6cae3330,17253902188
2022-11-09T11:07:44Z,PAYMENT RECEIVED,654847598,0,1e1e8c1a257275bde2175e2a4eb976c3a1e219dd93af59903cda16c5d55332ae,16600987072
2022-11-09T10:24:53Z,PAYMENT RECEIVED,636105864,0,4a7211acd5e872234664310e325352abd6a34c74b51782e23c275ff65c47a179,15946139474
2022-11-09T09:36:16Z,PAYMENT SENT,0,-1298101189,e628e6d6beb906849eb991fab5c21d824baca93f16cfbfdc5db3bfa741263d82,15310033610
2022-11-09T09:29:07Z,PAYMENT SENT,0,-643892977,3d7df9a5dd0325948884032bb88fc97d6a0c529a716e35a5617bfa91cef834d8,16608134799
2022-11-09T08:55:17Z,PAYMENT RECEIVED,639282215,0,6d55495a6dee7735f441232eef5e429351f69ad38c42c79b1684eabe4acad0cf,17252027776
2022-11-09T08:36:30Z,PAYMENT SENT,0,-2542636966,05e620b47d58f78d677e4500a41578bd4bf7f64f9e5a1a55cbdfc789097547ef,16612745561
2022-11-09T07:32:49Z,PAYMENT RECEIVED,642474152,0,a310c846bf14e893b619046eea6d2d488dd2f5de5f4ab15c0ff0b6ce48d4d71a,19155382527
2022-11-09T05:52:40Z,PAYMENT SENT,0,-4385345801,b5c3a1c7017b48b72ecc728237c2bad4339a42a762603952a0076b2ac699c06c,18512908375
2022-11-09T05:15:31Z,PAYMENT RECEIVED,630008043,0,11eb8e9277949a0595be3ef88f6138018d94f4677741db5105ad77cc5f1729d7,22898254176
2022-11-09T05:11:00Z,PAYMENT RECEIVED,641785376,0,850356c5e1db30a6d73fed823b33ca7fcda1f640514fbcdaf5d6ec652645863f,22268246133
2022-11-09T05:02:40Z,PAYMENT RECEIVED,634184641,0,cc566d9bdd314994ba341d61a1219794bb0dbaeb5c7ca1955335413029610581,22904874131
2022-11-09T05:02:40Z,PAYMENT SENT,0,-1278413374,e00d70ebe653131bdbe718d58b210bc293cbbfc5190d0a9f4325648361f0a3a7,21626460757
2022-11-09T04:50:11Z,PAYMENT RECEIVED,638652845,0,43ef8409fddb67e6f583e260122c8b79749ad83738fb93d1564604f25ca2080f,22270689490
2022-11-09T04:44:00Z,PAYMENT RECEIVED,640888977,0,fdf0a1e0e31e176427be034f5ecbbfab4b4a8136f478b32708ec8156dedf7b5c,22917729880
2022-11-09T04:44:00Z,PAYMENT SENT,0,-1285693235,47e26c8e48d472d71d307e8fe48b3e33ca24b2fb8b2c22d77a005e82240f5197,21632036645
2022-11-09T04:41:37Z,PAYMENT RECEIVED,653268483,0,41ef43a64b8946e370b9523c58bac5b297fd239062d175f4f6d5df52fb88ba4b,22276840903
2022-11-09T04:00:44Z,PAYMENT RECEIVED,641874598,0,be3175211bbb63c0ad634f3b4dd420326b330a5ddfff27ff8734d73f5ae88849,21623572420
2022-11-09T03:26:26Z,PAYMENT RECEIVED,630756438,0,629f90fd36c8a09d5d340acc5cbac76329dfafe2b869bb6cc79eacee12522bd0,20981697822
2022-11-09T03:18:13Z,PAYMENT RECEIVED,626340072,0,fdec6600c14da4d3074d45e2c5874ab3fa4976b25b1c295d8f99a2aee1e83d0a,20350941384
2022-11-09T03:16:27Z,PAYMENT SENT,0,-1960180390,0626f7adba38c3e5199114531520eb63b12b37917077fc66d89c4db74f8d1169,19724601312
2022-11-09T02:59:57Z,PAYMENT RECEIVED,636156541,0,5383b446620c03b939414220b0b61524bfd3c4efe2a99bf0c69ddfb39a51c73d,21684781702
2022-11-09T02:44:01Z,PAYMENT RECEIVED,654343866,0,607d805642e497857d3f3c6c98eae706c08d8cd5ba18077188e5737fc66aba6b,21048625161
2022-11-09T01:31:29Z,PAYMENT SENT,0,-1286322641,220af7782832cf9e627ad59a35d74d0f68c2ae01e71957b3a02c11f16521264f,20394281295
2022-11-09T00:59:33Z,PAYMENT RECEIVED,630360119,0,7ab514ab98a3914b515dbe797aded6cf81868a2c555b46c2ac6ebe53e00e95bb,21680603936
2022-11-09T00:55:19Z,PAYMENT SENT,0,-1285553726,6da848e6b5bc73f03c6e2e6acb91eb458d9806d63a6ad6115af584b8804ff9a4,21050243817
2022-11-08T23:48:52Z,PAYMENT RECEIVED,632971692,0,ef01d26a88d94f1e1342786f34787141f45745c9e9fb4ee18463878e91030d0b,22335797543
2022-11-08T23:40:42Z,PAYMENT SENT,0,-1262252175,24d71f6bee91ff6c5c5daf04806d3227e61def407f2c5aba9a437da10b4c8476,21702825851
2022-11-08T23:13:58Z,PAYMENT RECEIVED,625273262,0,eae2ff3d747ed1f1301758a0ed218f7c03a56e27f4e9acec9c1f7ad556eb9f2d,22965078026
2022-11-08T23:13:40Z,PAYMENT RECEIVED,628189028,0,8d3f73df4c7c0264b9ba6b748004dbdab6c3e8e96940397e9a09627bb0a326cb,22339804764
2022-11-08T23:11:46Z,PAYMENT RECEIVED,646832589,0,3983b301b6e1cb02f93c8136a99890ab6617051414b5abed711886b226949af7,21711615736
2022-11-08T22:52:18Z,PAYMENT RECEIVED,634355858,0,ac73f2f89b7a23d8add6813ac3dec062985fd536bdb12de7c61e4fea5ffbdcbe,21064783147
2022-11-08T22:29:46Z,PAYMENT RECEIVED,642933944,0,057340ba19c9794b6df146860d603888fc87bb91fea770bb779cf7a58584c4f3,20430427289
2022-11-08T22:15:42Z,PAYMENT SENT,0,-1918064731,778d91d3f4586d41ccc88fb9be37d8afb0142deae78a415c6edf8d58cba2f84d,19787493345
2022-11-08T21:43:09Z,PAYMENT RECEIVED,630350062,0,db54ddec96990f59185315280a1c045799ed863e10647e9bfcc7dec808139cf3,21705558076
2022-11-08T21:40:40Z,PAYMENT RECEIVED,642477747,0,affb945e165f5f548845eaac98515b74e68d8ac0af3e8030230b9c2541499aaf,21075208014
2022-11-08T20:01:19Z,PAYMENT RECEIVED,641883047,0,5819b4ff1737b24771d74f026d17b870dc33d29368ad45f02920b90e2d47cfaa,20432730267
2022-11-08T18:21:55Z,PAYMENT RECEIVED,644105473,0,3a86791e170d2e6bc88dfcfa2e327fe2a837da91d89e4a1f09d1c1c3cba33802,19790847220
2022-11-08T16:45:50Z,PAYMENT RECEIVED,646908222,0,0c2d3542a87272ca6fee3ab913fff7da271e564cf64d904b823c068474c56c15,19146741747
2022-11-08T16:36:06Z,PAYMENT RECEIVED,651192967,0,e716c84dc48a504a9e2e1afd67ff23be40344c1c9426497015e530acc0d97882,22359161827
2022-11-08T16:36:06Z,PAYMENT SENT,0,-3859328302,41c81db907deb19c3ca7c3c5b8bd7ed87b16c5df4547e6a45d5d89ade2af7753,18499833525
2022-11-08T15:22:09Z,PAYMENT RECEIVED,643892977,0,9fb90d4a5066f25a27a1d8a1a7c7f22dad2091cc7bb02c6e6af3a295c69752e9,21707968860
2022-11-08T15:10:57Z,PAYMENT RECEIVED,634742250,0,89db45e15f099cd51de96b36b7babe9bf4acacdf940604dcf3dbdd9dafe68a64,21064075883
2022-11-08T15:04:24Z,PAYMENT RECEIVED,642712304,0,9b2161ca24a77e2de0f9ee08317f38a083a02cb594aac37081744a3bddcc5304,20429333633
2022-11-08T14:46:13Z,PAYMENT RECEIVED,634719913,0,fc308e4761af4ccf5f830648b25276b67beeb282fd196a92940fbe60b1f19f1b,19786621329
2022-11-08T14:33:10Z,PAYMENT RECEIVED,630462499,0,c9df00eeac660c24cd47d4e68bfb654bb9fa129dfeb1a9f600eec6559e4f104d,19151901416
2022-11-08T14:00:07Z,PAYMENT RECEIVED,648766979,0,687af61975e14f4f993089b629381dfe2461a33df4b6160a9c6c106b199b850a,18521438917
2022-11-08T13:19:26Z,PAYMENT RECEIVED,643399879,0,66d43a6b48f63eea6ed85e84916bb1e32ac54ab3cdc00db42c9c3ee0a6237297,17872671938
2022-11-08T12:23:42Z,PAYMENT RECEIVED,642293356,0,db3bf11080c36f6ccd052d32f1e4b2269f4edc2ce0de8d5f3424d3181fc3da70,17229272059
2022-11-08T12:19:18Z,PAYMENT RECEIVED,647075552,0,a1892a9f97431adfca51c1a8192fa93c98854eca3bf5a45f19297b1e29be2b00,16586978703
2022-11-08T11:48:04Z,PAYMENT RECEIVED,660918082,0,578702520fcc345ed9b2142d366b6b2d7c2dc6a42d33e696ea44fbb8166fc115,15939903151
2022-11-08T11:14:32Z,PAYMENT SENT,0,-642626844,463576da707699f3aed4ef7bab7ece3f5fef52516bc74e41570e0e70c1e8faf9,18427463357
2022-11-08T11:14:32Z,PAYMENT SENT,0,-3148478288,a3a64d5d1d1396a6709936aa1073046e4f5dc5821bcde9149eb10be325444197,15278985069
2022-11-08T10:45:21Z,PAYMENT RECEIVED,652186756,0,d74011823b76317291b7167751f7ddac8a1f0a9a8477f9484b7fa3aeaefc5395,19070090201
2022-11-08T09:35:47Z,PAYMENT RECEIVED,644485053,0,d4f5dbf579b30b1a0bcf0656ba5c6890b114f827c448f560036215386a42b4b4,18417903445
2022-11-08T09:10:04Z,PAYMENT RECEIVED,641837588,0,53e05aef5ad82eda8aa7a0ef42c8ab4a7933954edb9aa12b3340810d6a5185c4,17773418392
2022-11-08T08:47:39Z,PAYMENT SENT,0,-1256878907,023ae1500c06b9d282b2b4d8a37d3731277dfbeb8cd57b23df451f18f4ef26dc,17131580804
2022-11-08T08:37:02Z,PAYMENT RECEIVED,641674040,0,adf935eed0153aad6bf54ce6ee8527133fc70ee6b7ecc5a297d08ed332e3ced5,18388459711
2022-11-08T08:25:32Z,PAYMENT RECEIVED,643879686,0,e8b0498aa51305d5e5132761c57fa4fdfa6bf7c6ed40c299fbe2159ea6b628db,18379707657
2022-11-08T08:25:32Z,PAYMENT SENT,0,-632921986,387ab536ba3c7563d8e3c09a1e09fb27bf3ffc1cd0e6f6d51d557ad0602ba72a,17746785671
2022-11-08T08:19:03Z,PAYMENT RECEIVED,626499147,0,fae1acac9f88a78e4150624e5976a597cf288d10f930ce5423e6c8681248b38b,17735827971
2022-11-08T07:54:21Z,PAYMENT SENT,0,-1913928970,c9e86487cdd22f7d5b4624aec8dc4ae437f66da49ebfd25bc3adcfb63dc3d36a,17109328824
2022-11-08T07:47:04Z,PAYMENT RECEIVED,625956157,0,455b904667d266e875d02ff9657749a9285ca5b5a6dff49c8c5c724d72fc1ecf,19023257794
2022-11-08T07:45:42Z,PAYMENT RECEIVED,631371427,0,c7bad40adfa484886ec9454f3e6039d1b71211f9ce0f67945f95b0e597e88ef8,18397301637
2022-11-08T07:35:23Z,PAYMENT RECEIVED,629646395,0,2650c68ed49e9b1116158b59e5bfca79144b50f33856b9380f4331ec41e5e227,17765930210
2022-11-08T07:06:22Z,PAYMENT RECEIVED,626719960,0,99880b3c3636a18edfe466e3b65747d0f40c436666f4232d62fdebc715234698,17136283815
2022-11-08T06:57:51Z,PAYMENT SENT,0,-639409516,f56da56332d250cfee403e771149ad5f24bf01dcef332aa5e7d62d8eb1b649e2,16509563855
2022-11-08T06:44:03Z,PAYMENT RECEIVED,626343016,0,9cf9b3c9bcc1e7b54f00ac755ed58f18edcb3ee64e694ada1ee25c0b529ed878,17148973371
2022-11-08T04:42:35Z,PAYMENT SENT,0,-633069137,3714b4dccb6a1c8e8e21c52bf48170003718d6985d314ecabcfcbe72f7ba250f,16522630355
2022-11-08T04:25:50Z,PAYMENT SENT,0,-1277325189,ccb31ba9084a182d3d8bc48ab54e6a7d1fce42ed001762a1b2bbf5a9eafe3e68,17155699492
2022-11-08T03:13:15Z,PAYMENT RECEIVED,630880748,0,12efa1f4729073a7d54fe0902826fdde1f182ed570436eaa90595e6d5aa04943,18433024681
2022-11-08T02:53:35Z,PAYMENT RECEIVED,634679630,0,806b2378994112dfc84c5642fcd4f612f54a1954a709d3a32d68bdcf668980c0,17802143933
2022-11-08T02:44:07Z,PAYMENT RECEIVED,627143686,0,9f9ab45a986ec6c9d7c3cefc718cdd78e0bbba5949c634817fe233a4864e30ad,17167464303
2022-11-08T02:41:47Z,PAYMENT RECEIVED,641092798,0,715a1bbe68a17708847a0c569b6565e0be454301defbb96707e43d9c1800d916,16540320617
2022-11-08T02:08:31Z,PAYMENT SENT,0,-1259108304,b81f87d9f87e97c1e49be076765357eeb51aa2529906056516d399cdc7619b48,15899227819
2022-11-08T01:49:36Z,PAYMENT RECEIVED,626371305,0,ddcb85ddf014a54457724362ad9715b3b88de264a7474853b64805a78851d8a8,17158336123
2022-11-08T01:42:46Z,PAYMENT SENT,0,-1901987702,b1d2e974c98b8be83e937512348c0be4062f268c51b3d2ede9e22c581b47f125,16531964818
2022-11-08T01:33:52Z,PAYMENT RECEIVED,626312530,0,f5ef7678c7620171cafb9e51c68414ffd14bb2bfec8475913028906de1fc2e53,18433952520
2022-11-08T01:11:52Z,PAYMENT RECEIVED,642292303,0,ac6b78efa168703c8fbd5e5962af48de9fd965351c3090d6b8de78f3670827e1,17807639990
2022-11-08T00:53:07Z,PAYMENT RECEIVED,641716569,0,fda374b6b02ec1d4226280073b092840344ec1c89892639fda84793e4327742d,17165347687
2022-11-08T00:36:26Z,PAYMENT RECEIVED,644503521,0,da95788ea3fd0d03889841dd0a81b06b33e39f7a8c22129fdd34797c03936f0b,16523631118
2022-11-08T00:01:39Z,PAYMENT RECEIVED,639221920,0,c9f197bc7d57a86f1306789675bbb17352b98991e5d19c8e1ed09b1b69682c65,15879127597
2022-11-07T23:58:05Z,PAYMENT RECEIVED,641585581,0,84cb812ceadd0505040e2e1a66af03c1a6deec92d5ef72e6e96df26b28df3a29,15239905677
2022-11-07T23:44:02Z,PAYMENT RECEIVED,640424576,0,9a5243ec8f3788607dbc521189442a444475e35d9afc8c34b859371ab13e4e23,14598320096
2022-11-07T22:50:16Z,PAYMENT RECEIVED,651876135,0,66bd7c8d188cb6fdd5bd50adb26cdbc152f5db673a6592317fcb3381e02ede5a,13957895520
2022-11-07T22:32:09Z,PAYMENT SENT,0,-631024911,a827cb23a0ca4086743e606ef2ef014397b7576624cb1bd7863d33857b0fef5c,13306019385
2022-11-07T18:14:14Z,PAYMENT SENT,0,-3177881803,ca008d332330fa6e6e0f3b7439e0b25425dfb81cc806e330b41e6034856003a3,13937044296
2022-11-07T18:09:48Z,PAYMENT RECEIVED,642626844,0,5247e07cd70d9f1a468fba50a7abd603c60ec1dd89cd4e7f4f101a774d9081c6,17114926099
2022-11-07T17:38:43Z,PAYMENT RECEIVED,635418798,0,c920eb12dea13165ace613cb2125c4e8f200cd45df2bc5554a1cdcc308868a6f,16472299255
2022-11-07T17:01:41Z,PAYMENT RECEIVED,632319010,0,ad34b0c54d0bb2c1e38b2e4bef8271f062f20aa7b8283e6f3ebbcf0fec558280,15836880457
2022-11-07T16:48:13Z,PAYMENT SENT,0,-2563446058,8e486c35fc4f05ff9b20289b53e9f409204a6ac73f64ee8a8924bd055bdfd0e6,15204561447
2022-11-07T15:56:22Z,PAYMENT RECEIVED,632921986,0,9f2db20dbc63040940d8e54dd6ac78c90b1717ef00568918b11de59b81b4cbea,17768007505
2022-11-07T15:24:07Z,PAYMENT RECEIVED,632188562,0,e180e32274ba7c1f8f70808ce54061e7cf9c3676cdd2f70024390209b9249240,17135085519
2022-11-07T14:50:39Z,PAYMENT SENT,0,-1934504271,2a76599530a931f55d318538c98e7cc03fe7816f07e0a52ad2124293602757c1,16502896957
2022-11-07T14:45:08Z,PAYMENT RECEIVED,636785571,0,6e62520ffb4e78b7568ec508490e7f902af7694a458cb3bd0d09f00aade1d8f4,18437401228
2022-11-07T14:41:15Z,PAYMENT RECEIVED,644954837,0,d236ce9d0c11c607eb201508ffeadfb4a24f381f3f78578e8c9d249474a15a7a,17800615657
2022-11-07T13:50:31Z,PAYMENT SENT,0,-655817749,c9866aff5d009f210611b977f21ca03ad98799f9e3ba297c1f0b53738d7031ca,17155660820
2022-11-07T11:36:26Z,PAYMENT RECEIVED,639409516,0,07b8a1fdc6ecb502ab21ca86edb40363c6419ef5e770eb640d5c48a71fd3e153,17811478569
2022-11-07T10:18:31Z,PAYMENT RECEIVED,633069137,0,529b008ad6432d9cb8a7d15952d2a53519b8fbb017f9284a35d40becf6cd36cc,17172069053
2022-11-07T09:43:10Z,PAYMENT RECEIVED,637286929,0,a2ef0893dc66b3a1a0c9f0269ac1b260ab33d983fa0395f8ac2403c12d6d7d0b,16538999916
2022-11-07T09:30:35Z,PAYMENT RECEIVED,640038260,0,a66134a0e31030aff3d8c944d6721f9c7415a407eb641a4eb98934596d0db7e4,15901712987
2022-11-07T05:23:42Z,PAYMENT RECEIVED,626029793,0,339ee6b475ecb78c4dabf014608a1d22ed4d66c748fbe0cda0b36a385f547780,15261674727
2022-11-07T04:40:29Z,PAYMENT RECEIVED,636213953,0,a08a7118ee1fe6f4638fff4a83497169c61c3ca186b75a7da04c90d2f64da5c3,14635644934
2022-11-07T04:15:05Z,PAYMENT RECEIVED,635133990,0,334ab61e180117c0b16eef099795859ac8c8f1836c8b11856896ab740716c29c,13999430981
2022-11-07T03:42:23Z,PAYMENT SENT,0,-4390525817,8e841bc1dedd507094ba5cf903ef2a6b5877f951ae74c53ea097f744c0951248,13364296991
2022-11-07T03:16:45Z,PAYMENT RECEIVED,626725224,0,63c82e34c2fc2c2dd64b98af815187ff27bdcafb5f1d45a2b14fb97149ad0b9b,17754822808
2022-11-07T03:12:57Z,PAYMENT RECEIVED,627985463,0,5ad0b3f22b6a44770c5e6bb264bc95fa6e7279957680f70aca83b4cdfa0a1497,17128097584
2022-11-07T02:46:56Z,PAYMENT SENT,0,-1288847898,2656806a2d795ab30c7ffadfd590b06c67ffe8d5cce7935adfd3dd70d24e3b68,16500112121
2022-11-07T01:19:40Z,PAYMENT RECEIVED,628797845,0,046634b8e598e5558b155dd1e73787ed1cf867cfa7af17f733e6b369209b246f,17788960019
2022-11-07T01:13:19Z,PAYMENT RECEIVED,628081062,0,e25221efb8090c5a0393b8e886267d5e1cda7456df96485afa6077fa00e207f6,17160162174
2022-11-07T00:58:37Z,PAYMENT RECEIVED,630639759,0,d98d32391f46f8d88fd6de42bdb3239c81486ab37b4c03cbe8548afcffecd620,16532081112
2022-11-07T00:49:51Z,PAYMENT RECEIVED,637161371,0,5a93ac6a65bc2db5e293beac8e1a54dfb9e2722cdc7c951125113e892df6e74d,19056494126
2022-11-07T00:49:51Z,PAYMENT SENT,0,-3155052773,3f4b93385c01fdd2a56282f46d2a118d4fa0a5e268f36b74e0bc3c366a83c136,15901441353
2022-11-07T00:05:22Z,PAYMENT RECEIVED,642935502,0,1a2790974b85adf8a2ddc216b334a10f7b60405b53d1453672f7c13a6dd43e6f,18419332755
2022-11-06T23:41:49Z,PAYMENT RECEIVED,642896322,0,b960b4b505b5ba35a6425d22e3a521351b7399deabf71babb6eedc301706a5c9,17776397253
2022-11-06T22:46:01Z,PAYMENT RECEIVED,629251340,0,3721d8c4a34e2c9e00af925623382db6b5b2a0b99bcdd36340e26b3eb11eb7f5,17133500931
2022-11-06T22:43:49Z,PAYMENT RECEIVED,631024911,0,417efa748c84c79dee89220100dd4e5477137fb8dc6081d24d2f0c845e1197a5,16504249591
2022-11-06T21:50:50Z,PAYMENT SENT,0,-2540807785,b2b5fc4ab1f121db73e4735807a11c2df06790110b5f07d84f1476d3f30da3f9,15873224680
2022-11-06T21:37:13Z,PAYMENT RECEIVED,644036517,0,abcf00a6f81e5203a4f6b9bb50ed40eac92e6e05a3a67f9152dc489b1a535274,18414032465
2022-11-06T20:00:42Z,PAYMENT RECEIVED,637662798,0,3703861bdc91eaac95ec99538845207d7f10c1c43689b0e875c372a5f441f1f7,17769995948
2022-11-06T19:11:21Z,PAYMENT RECEIVED,635165086,0,87a48490e7818dd875dd6ddbf6d38ceed399e8b929012ad5fe9f3c26c332796f,19699576376
2022-11-06T19:11:21Z,PAYMENT SENT,0,-2567243226,743d079c93a17c3e597e710bbed5e64b48b398929c6327082c5859dc4a20511d,17132333150
2022-11-06T18:53:33Z,PAYMENT RECEIVED,646414613,0,a9c14a8938ef3bf5f66be5698208a79164cbd7c3669b982a951d95b50d326ce9,19064411290
2022-11-06T18:22:11Z,PAYMENT RECEIVED,634612348,0,4702f182dcf8b8e6e47256b59b334f2523945f0b05cefb0519d62ec78af90ea9,18417996677
2022-11-06T17:43:51Z,PAYMENT RECEIVED,633280200,0,222a72e6be1eff5f56887955017c488396527c77107c7a07c0e0655ddb25f6fa,17783384329
2022-11-06T17:40:30Z,PAYMENT RECEIVED,638024616,0,e0219b1de463dcc83b322a8c6326cb8f691f888ad1314404286cefb31987a640,17150104129
2022-11-06T16:53:58Z,PAYMENT RECEIVED,655817749,0,f1e6bae54e131004301c9777054dae2dcd6172e470b0424efde47f9278720721,16512079513
2022-11-06T15:37:27Z,PAYMENT RECEIVED,629856964,0,40bf4fc5691ba8737e59e430798daf92d30e7dd50f40c8e7db0948e84fbc8bd8,15856261764
2022-11-06T15:04:10Z,PAYMENT SENT,0,-1937388720,597c88426b659e41fdfbdd1762d612fd6f29e41b8934bb8458aa5bf97714fceb,15226404800
2022-11-06T15:02:56Z,PAYMENT RECEIVED,644053141,0,112bf053b94bc014be790d83ac9467a84f769cde5496fc2b8064a582029ad7bd,17163793520
2022-11-06T12:46:52Z,PAYMENT RECEIVED,639589618,0,a86154c3f7a78460fc800636ff3b9284d0f981616cf94927b53fa0ae22890585,16519740379
2022-11-06T10:36:58Z,PAYMENT SENT,0,-650842261,cd5886d4caeea7e77c6a90ae5527fa2de396cbe985bfcd10a3bd6e5bce739eaa,15880150761
2022-11-06T10:30:07Z,PAYMENT RECEIVED,626163921,0,d06ea1a8c883d17f8e799754307dd034dcb150d00f9d58c9bc66e33a38083ae3,16530993022
2022-11-06T10:16:56Z,PAYMENT RECEIVED,647735602,0,7834100d4b54e89dd8abdfb5c454fd931448fc31f5858e6a331e3011a255d245,15904829101
2022-11-06T08:05:48Z,PAYMENT RECEIVED,641112296,0,9d6d8a4c7d19570098126114c04cf0ddcfbabe6e45018545d08c48dc7fa9b47d,15257093499
2022-11-06T07:17:34Z,PAYMENT SENT,0,-651712437,6b079a2a312ad09dbfe032fa49a2fb678a9f29b79239fe63457316056edbb130,14615981203
2022-11-06T07:15:00Z,PAYMENT RECEIVED,630269045,0,277ebfcd855915f4b42a57c39ff6289b6715630ea9f9055bdc82248ee2e674cb,15267693640
2022-11-06T07:02:23Z,PAYMENT RECEIVED,631855718,0,7ac4cc085f96fda70710a0fd96193c592074fc77899a92ae069396c4262c355f,14637424595
2022-11-06T05:41:24Z,PAYMENT RECEIVED,627138223,0,959981727482307d817e9819ec2cc4462a44aaca91314786ed123ca0667790f9,14005568877
2022-11-06T04:19:06Z,PAYMENT RECEIVED,643896111,0,9bbc5c193fb6f048dd683b7c8d37f05f495215698fedf2337bffe7d2a34c41df,13378430654
2022-11-06T03:24:07Z,PAYMENT RECEIVED,628958023,0,dd739bf55f4655ec07f02242c8a1891abd9067775958fb0fe7dd51c5734504bf,12734534543
2022-11-06T03:18:04Z,PAYMENT SENT,0,-8200045688,1df64ac2e3296634d393cc10f7ff170c4d9a6c7fafa8612c7fbf60e5a5a315f1,12105576520
2022-11-06T02:54:29Z,PAYMENT RECEIVED,632138928,0,4b1ce4469c2f90e0445dc7d70115cf4806a58631ddc2c8ce0455da59701ba213,20305622208
2022-11-06T02:09:46Z,PAYMENT RECEIVED,631880877,0,656dd686bd47d9550000b00ea0fbedaceb98973ef450bbfa0b0c1bf17e974eeb,19673483280
2022-11-06T01:37:31Z,PAYMENT SENT,0,-636881874,42e8cb508cd9d7307aa59d7b218c696f297feb398a030f02b36bc143d0052eb9,19041602403
2022-11-06T00:44:48Z,PAYMENT RECEIVED,639860903,0,467019b3634285261221519bfb688841a63003c5ae5f08e27eed8fc0b85c6358,19678484277
2022-11-06T00:38:58Z,PAYMENT RECEIVED,653450135,0,2b149a0e6d21a88ab457b82cbd9d624e64f56bba610cbdf3f0151b4cb92e9f42,19038623374
2022-11-06T00:04:17Z,PAYMENT SENT,0,-638114283,f400b1cc516da8c7634aeafe459465647bf791c9295cd23db2f70562229ab095,18385173239
2022-11-05T22:05:33Z,PAYMENT SENT,0,-1921135063,cfb9ce4e6fa434c8a240b307cd8b43674e91e4e35c74c4fd2862996adc31b988,19023287522
2022-11-05T21:50:01Z,PAYMENT RECEIVED,627718957,0,155cd990239d65324b9db21b810820eed3e954c42036e1dfc2bf2f4ab1f91737,20944422585
2022-11-05T21:46:17Z,PAYMENT RECEIVED,632031468,0,72c889ebc13ac606dcef25355f9af9a7841c97c6fc4c3c7d594834cb637d411c,20316703628
2022-11-05T20:28:31Z,PAYMENT RECEIVED,625885819,0,00fcc132d47d3778d527516a5cd85f980535d767c74b891c713f92d391b806f9,19684672160
2022-11-05T18:28:16Z,PAYMENT RECEIVED,636587963,0,c1c298bb79f0b5492f98a4d0d14394202e0bb44e0dedbabefc019596437e979c,19058786341
2022-11-05T18:25:50Z,PAYMENT SENT,0,-1286754248,52e399deeb3c41296c1f4838edc19999d08bc7ccf645780f5b7e0a44a776e2c5,18422198378
2022-11-05T17:46:54Z,PAYMENT RECEIVED,650842261,0,d761ee36180d9dcb8c6ffcdcab845d5b5415fed913f666bb01185e1e3e451444,19708952626
2022-11-05T16:57:00Z,PAYMENT RECEIVED,632741278,0,ec785d3571d71392fb5f085db9fc74386cd32af74713a3d7a8a8e637ac6fc556,19058110365
2022-11-05T16:49:42Z,PAYMENT RECEIVED,629453519,0,2bbdcee140406e32363b256fe4a90f82df0e25d3a1ad1fb29f94ee6e4000c793,18425369087
2022-11-05T16:21:23Z,PAYMENT RECEIVED,631593614,0,6b392234f02ecb717e2499a6304256705f98741a55ffb0c6e2ca8609ca6ae45d,17795915568
2022-11-05T15:46:29Z,PAYMENT SENT,0,-1945937433,aef49050f24de6d4405bb77368535e0bdcadd2cfd5bae1b5fea4e14abd63576f,17164321954
2022-11-05T15:19:50Z,PAYMENT RECEIVED,651712437,0,e5ea6f7fb32c0b68f2bdb69a692b2351cf078ce4dcc98a4b6184f92b85a97257,19110259387
2022-11-05T14:13:43Z,PAYMENT RECEIVED,637344225,0,290ab677bfe5cbf312667153aaf9474ad786edd0cedf5ceba63b959f78cd628d,18458546950
2022-11-05T14:03:44Z,PAYMENT SENT,0,-1948142839,d1a24b4260638d3fe0e03f8fb92313b2cd67d45194fa69bc11f0ecceec2ef8fe,17821202725
2022-11-05T14:00:03Z,PAYMENT RECEIVED,626155958,0,83168b10e3558d7778056ae313808a0d52e6c790ec142070a43b92441a2b1fbc,19769345564
2022-11-05T13:36:39Z,PAYMENT RECEIVED,628504916,0,7e1ee6831698c924ac4269be7db6330c9e7cddf801cc9e6b132acf955c4669bb,19143189606
2022-11-05T12:52:20Z,PAYMENT RECEIVED,648063007,0,6306041ef8798253da4332583e0d434c08d193690fcfd2f640dd333ef00d044b,18514684690
2022-11-05T12:10:35Z,PAYMENT RECEIVED,646018929,0,5ef5c519f4edae20eccd6894aee0da5aa0bad51bc079b44084558d8d7aac3ae5,17866621683
2022-11-05T11:10:36Z,PAYMENT RECEIVED,643306784,0,25d48ced15b23602047a6bc5e16d39c1646c631d44dade77b4ad7e37cf844d6b,17220602754
2022-11-05T10:49:31Z,PAYMENT RECEIVED,644892515,0,0bdf3f5067861ade5667e9e730f8798de41482f892a686f06c55586be264d609,16577295970
2022-11-05T10:15:39Z,PAYMENT SENT,0,-1970125962,6b4757a3a39702874c4f2b88a3187dfedd884f29cdf920e88a79dd4f3b6c4a56,15932403455
2022-11-05T10:04:20Z,PAYMENT RECEIVED,629420384,0,59d168e7b5a037793fb3c0e74e4ef9e6767454e08d7907c8298809c2ab7284a5,17902529417
2022-11-05T09:21:11Z,PAYMENT RECEIVED,628354614,0,c26774cf72dda0b000b4bf862f5c516d168e51d12ac57a758e9f62bbd363f570,17273109033
2022-11-05T09:06:32Z,PAYMENT RECEIVED,627607979,0,8044a000dd6a42aec2a33d96ed99832d269a2876b4edd94b7efc36e264805958,16644754419
2022-11-05T08:42:38Z,PAYMENT RECEIVED,630173829,0,078b4b26b3bd25bab53fccafaf8cdb9e4c1178a666a9f5548e6669dca6e87446,16017146440
2022-11-05T08:34:19Z,PAYMENT RECEIVED,630305782,0,69e0e24336b4b7813bf551c9026216458b482ac589c44f6cac17fca0beea3922,15386972611
2022-11-05T08:08:23Z,PAYMENT RECEIVED,632424585,0,521aeabf0a2175a8a626c0976184c5eb43539d7c39367041a7e0e39a554202a5,14756666829
2022-11-05T07:35:59Z,PAYMENT RECEIVED,638114283,0,16962b5441dab85bb9b5e2402d3a1f29154805c7fadce54dad5e753b11afc8de,14124242244
2022-11-05T05:16:04Z,PAYMENT RECEIVED,640438649,0,8dba878f2d479eef6437a24928c2140eda1da810edb1a9824d31d29e7a1d9244,13486127961
2022-11-05T03:33:48Z,PAYMENT RECEIVED,629350248,0,58d9be5cc507f03b2d55d7107bb3fad839b5342efed83a5b8a66e75c748bcf42,12845689312
2022-11-05T02:36:10Z,PAYMENT SENT,0,-5675181975,b4501ad25e1fc9010c9262eee106e3a4a76a3dcb3e7b21939584984c58d4a546,12216339064
2022-11-05T00:34:06Z,PAYMENT RECEIVED,631877199,0,da6fee37a044e0c2853852e4f457b6ef5065771aca27b06de19d162780abccc4,17891521039
2022-11-05T00:28:08Z,PAYMENT SENT,0,-2555674954,e63cca98ce7d3b72b622984a3028b79c156fb4d0a33a385f64c240c0bc600289,17259643840
2022-11-05T00:18:27Z,PAYMENT RECEIVED,631648424,0,8a14b36a5a41f0d4e9f3bbcf3a2eb5cec9b19ea61f49160f5e732501bbda0b7e,19815318794
2022-11-04T23:34:12Z,PAYMENT RECEIVED,656140124,0,d389caf521a011be0136d5fab9286eb6bcc5d46f7660137dcd393563bab99f01,19183670370
2022-11-04T21:18:46Z,PAYMENT RECEIVED,644603150,0,d370788de3bd2ec7ad8508dbc5feec9094816e30b9557875314bc5d32b60cf31,18527530246
2022-11-04T21:07:40Z,PAYMENT RECEIVED,639771412,0,3ca5780d06dc2d82c8be54886447e7c43438b1ec38f273af7d9d61738c55a055,17882927096
2022-11-04T21:05:14Z,PAYMENT RECEIVED,643152538,0,5f6267a48ea532fc5a73c4297c033aaaaa287ffc7b80a20451d47fdff133c9bf,17243155684
2022-11-04T21:01:42Z,PAYMENT RECEIVED,647463969,0,092fc7de057a1812002030979b7edafb1d574dd1a731000c6846231c2731d610,16600003146
2022-11-04T20:51:51Z,PAYMENT RECEIVED,651608322,0,044aca6e3d8bef2d30c4c5e5e15b0690a64b2af58ad21dc5f993a9801357959f,15952539177
2022-11-04T20:33:05Z,PAYMENT SENT,0,-1927732911,daeef0d2778b37c400e498c51f267d68a3af2784636251fe5cc7a49fa762f613,15300930855
2022-11-04T18:32:04Z,PAYMENT SENT,0,-2582750967,4ef1c0bfab514955959eb543b50fd3a72aeb2fd2ecea22d2f69821d5a8265c6f,17228663766
2022-11-04T18:31:33Z,PAYMENT RECEIVED,636881874,0,ba946631cb8d905fd7b6e3db3395be4abf1ec57dab6a42d54c18887cc6d7e5dc,19811414733
2022-11-04T18:12:10Z,PAYMENT RECEIVED,640925002,0,fa3a3f8fc35b8e89c7220725db7a6ca5e8a014fa8ae4d2aedb9a8e7a4f5c6912,19174532859
2022-11-04T17:01:24Z,PAYMENT SENT,0,-2604734218,3556c9807d253f5ea2240d028292a29b5c351768222dbf6eca561b1b356080f2,18533607857
2022-11-04T17:00:40Z,PAYMENT RECEIVED,645194159,0,64d4ad9697340c3edc46c12736b63e5964c1f8cecacc1a196a245882651063c4,21138342075
2022-11-04T16:05:40Z,PAYMENT RECEIVED,662532685,0,99ef4a1b35d69c73267567b7b8f80abaf201a97cf3680817dabd9ca4f2c223c0,20493147916
2022-11-04T14:58:46Z,PAYMENT RECEIVED,652530227,0,ddce8aa7bfcb355c2c933d38b1705ca3acdb4cec299abc55807eaaafa81cb7af,19830615231
2022-11-04T14:25:04Z,PAYMENT RECEIVED,655063050,0,df358cb3cdc33eacf8777791f221621284e0209234c37cba40d9bfc2a6635fde,19178085004
2022-11-04T10:42:15Z,PAYMENT RECEIVED,626671736,0,1f317f5389c0d8c8f7ebf866ebc3416abe03a166d820703f174fe1789febf0d6,18523021954
2022-11-04T10:35:16Z,PAYMENT RECEIVED,643601710,0,aceac7be20b4f32e04f7b9c54616814e23c8099bf705d57dcbe330d5242b64ff,17896350218
2022-11-04T10:10:58Z,PAYMENT RECEIVED,649070548,0,a22dc4d117086e5dc2d4e79e26b18ca96c91a741d4346d7cc231d55eac82b725,17252748508
2022-11-04T09:56:13Z,PAYMENT RECEIVED,625823058,0,4a402afcbb6d9b4a152e17c99a8e465f5842e5bd401423111128e9d726a87834,16603677960
2022-11-04T09:55:18Z,PAYMENT RECEIVED,631495335,0,69ba76de940696a1c4f27b30fa443134518d3f73570f05e005bd5c08c78a78b9,15977854902
2022-11-04T07:42:43Z,PAYMENT RECEIVED,625435409,0,5af01178da77ce2f01b07b6cf525d74030a2d47c786f67ac68e270a6e38e5145,15346359567
2022-11-04T05:20:01Z,PAYMENT RECEIVED,632996693,0,dd51cee84efadf6993cf9e0999edd859416f179a8c9280f2713e3fe33df0bbea,14720924158
2022-11-04T03:56:54Z,PAYMENT RECEIVED,638063284,0,d0ad4d174562722c75b4046fdd21dd774b5e77a0cbdd227f8b1b23fb90e4fbfb,14087927465
2022-11-04T02:55:59Z,PAYMENT SENT,0,-5051410593,3fe93f3ec1630f84332575b33b2781759706c45ec04b4528c9dd164bec3ca2ce,13449864181
2022-11-04T02:03:14Z,PAYMENT SENT,0,-1265779929,bc424240a7fa2094305fc7fc6a6e015ede5d89219f441cd43ff12c83c058b256,18501274774
2022-11-04T01:45:11Z,PAYMENT RECEIVED,629485962,0,b6641496c747f70011f1ab68c4dd18bc24505ccdbc3d1489fb1b2779901ad1cc,19767054703
2022-11-04T01:33:27Z,PAYMENT RECEIVED,645412514,0,34e42a31540f2b840b721817fa33ec598e060b13d2f0975c9565e5b03f5025a1,19137568741
2022-11-04T00:20:43Z,PAYMENT RECEIVED,632137722,0,3279e761901b3d1455b9b8239cc615082816963baec38fcc05b272a6bee1a686,18492156227
2022-11-04T00:14:10Z,PAYMENT SENT,0,-1276954554,eb66b9ceb4a55be4430742879b0c2c890f8fbae25a724eeec51befe0efaa7c9b,17860018505
2022-11-03T23:37:41Z,PAYMENT RECEIVED,645047694,0,d38760a850bb8a0f797b1b8442a5f29edb4c77fbfde52f265f89f9b4fe3f40be,19136973059
2022-11-03T23:06:23Z,PAYMENT RECEIVED,644599593,0,8e99a12a2d2eaeffa2d54f9de68ced11d6599948a17ca8d0a9e50ea6d5865425,18491925365
2022-11-03T22:44:51Z,PAYMENT RECEIVED,644498799,0,bde8aa91e5f83b3aae217c1c494fc2a13716d3a22ebf1e014d45d5ae5ac50836,17847325772
2022-11-03T21:25:39Z,PAYMENT SENT,0,-1266087734,1cc238245cfa82baa890e5cfa665f8a1b80a7b6da0a0b3c6d5f2530d655f31ac,17202826973
2022-11-03T21:06:02Z,PAYMENT RECEIVED,648604881,0,cc3070a4ca02b9baf041caf360e4c8015de1b5ca113680d481d57159e6f87b77,18468914707
2022-11-03T19:45:46Z,PAYMENT RECEIVED,627692551,0,b6c8aae5aa83bd558e863b04cc0c5a430744a5127c68666ac1b4e7d0b47a7d7b,17820309826
2022-11-03T19:28:43Z,PAYMENT RECEIVED,625545652,0,5d15fb02affde199e697c143d49e278e8af58d8b0c7a7a7c15ad371b122ec6e0,17192617275
2022-11-03T19:24:58Z,PAYMENT RECEIVED,632321466,0,054911f2dc7c850a684261a7d5762d0d1a017d9f4367e2236e3f93a99ddcb3cf,19104364346
2022-11-03T19:24:58Z,PAYMENT SENT,0,-2537292723,296c54ee133ced64e2b3abc672ef4b9b7cda668b1270d651db5fb67e0fe62051,16567071623
2022-11-03T18:44:52Z,PAYMENT RECEIVED,643122186,0,a5e004b013d63b6ad81e4be954c4b94e181d2344cf698cd543bac9cb773482f6,18472042880
2022-11-03T18:22:10Z,PAYMENT SENT,0,-3825006906,347fb0c855269f98c990df9fb43aec0d3d8522e0eff25a1f53732f29d00f5659,17828920694
2022-11-03T17:59:03Z,PAYMENT RECEIVED,638339982,0,2261fa2b29960621e7706e0624dc2141d6e2c15142977b2c4f54631dbeefaa26,21653927600
2022-11-03T17:17:25Z,PAYMENT RECEIVED,632772563,0,81f460bb631c3575ec1243a58c756ac6f54bdddbd60a43360c01f9bb283c3a08,21015587618
2022-11-03T17:15:17Z,PAYMENT RECEIVED,639468926,0,7b44126bd1504a0ecb75c3fd25a5f8631469339b75a41d92bdb149c79a212349,20382815055
2022-11-03T16:52:55Z,PAYMENT RECEIVED,664467127,0,7a7cb7ffc428c6ab023a8de81d3fb3ef1ce1df943cffad20a5236c0721a042d3,19743346129
2022-11-03T16:24:29Z,PAYMENT RECEIVED,646868243,0,faefad5555396e16c65c38e24f8c2d413c035384ed9907cb33efc53fe1b5a399,19078879002
2022-11-03T15:54:05Z,PAYMENT RECEIVED,639802762,0,5d686cc0b77397c193126110457f6928228dfa320a1c88a5690bcd08eb7d8b8c,18432010759
2022-11-03T15:42:00Z,PAYMENT SENT,0,-1290365425,9b51286cc859efb50d28dfc1769ce2d382d814c6436685f6b55a677156c99457,17792207997
2022-11-03T15:15:17Z,PAYMENT RECEIVED,640974879,0,da6684f2bbb69b881bb2141dd24f349873b6116cf459ba4af65fdf9e315ba314,19082573422
2022-11-03T14:29:15Z,PAYMENT RECEIVED,650276662,0,80c4fe8bcec6a69d7ded1fa8fcdf2b472de1fde8d299b74319db9b2047f9df3d,18441598543
2022-11-03T13:33:21Z,PAYMENT RECEIVED,636793957,0,d7a0b1fd96f21771b44e224af4e238113bc5e07994fb36520c60beb4165528d9,17791321881
2022-11-03T13:15:29Z,PAYMENT RECEIVED,641345518,0,5c5711368868f7ff26476f22b88a1b991241269c939d707e084b349e889d9bde,17154527924
2022-11-03T12:43:00Z,PAYMENT SENT,0,-1317561433,56226aecc3c2ac3d1658ee59873fc7e760fddddc4523d75e9049d9df500022b8,16513182406
2022-11-03T11:31:18Z,PAYMENT RECEIVED,655652390,0,aceb48e68e9e277147723c0d21bf394e9233da0841deeacbf80e74a0db2f6926,17830743839
2022-11-03T10:52:24Z,PAYMENT RECEIVED,634549844,0,d2821ddf8feae435d320bd2398e327f92d138d367a6af27d81627bb54f9e0763,18454148445
2022-11-03T10:52:24Z,PAYMENT SENT,0,-1279056996,e3df34a8ed0a0228a4dcb5e7e0cca0a2c1f2815e37d5e3e04102f46e827ae251,17175091449
2022-11-03T10:39:45Z,PAYMENT SENT,0,-2588534426,7dda3464d2092a2c141cec1fdc776614b12cde32aaf88f2471000390b6a37cab,17819598601
2022-11-03T08:16:14Z,PAYMENT RECEIVED,645578785,0,ce9c754e38489767fd16e052a41eaf3995b4c115336323311bd3ce44d6a5c11a,20408133027
2022-11-03T07:59:09Z,PAYMENT RECEIVED,631230085,0,490a2db8b363774ad0f36d9d5707fba5fe727fe457ea0f4ab488dfba4c7008f6,19762554242
2022-11-03T07:28:28Z,PAYMENT RECEIVED,626180645,0,b86b5dd428860c66a6169d56f3f082bced83ed2ac093828c3a401f228f2766ca,19131324157
2022-11-03T07:26:53Z,PAYMENT SENT,0,-654475972,8fec75894a8dc16b936e92588ece481b4ac64485e25804a868f3f945a188265b,18505143512
2022-11-03T06:27:51Z,PAYMENT RECEIVED,633762150,0,207da156a3cd0ab9f2d8ca07396b64a36c2314f4c66c80a15fa82cc499fcb45d,19159619484
2022-11-03T05:18:06Z,PAYMENT RECEIVED,629965174,0,521ee2be16b49994e5b7e2d2af8d1845cb208394f087d131d3afbeed9b930fce,18525857334
2022-11-03T04:04:33Z,PAYMENT RECEIVED,633801382,0,54330d84d65cf5732e7fd7efc5a68fb9043f579346560e96553732461911a920,17895892160
2022-11-03T03:58:34Z,PAYMENT RECEIVED,637948461,0,b76116e73c548f60c463b1e579a54f14791a94a4ac17af0bbf5e4d0a6919cf53,17262090778
2022-11-03T03:41:26Z,PAYMENT RECEIVED,632325584,0,4e82576f9cf80d095ee72b6b25a4533390250ad7e13cceb9fb16274e3ed91f89,16624142317
2022-11-03T02:47:29Z,PAYMENT RECEIVED,631375769,0,78269dd843d7e0444887e84adfd6c48000979fab192e85d74b635bed8cd2395e,15991816733
2022-11-03T02:27:00Z,PAYMENT SENT,0,-7562846741,11fdc432f2be0beb9095f7b166d799064b803a3d24284a420def17f0e422be84,15360440964
2022-11-03T01:27:15Z,PAYMENT RECEIVED,633132566,0,072217f6a44a86fb0bbadf655a706e0847b4c422b99e0b72f4fa2b1b2fc38bf9,22923287705
2022-11-03T01:26:00Z,PAYMENT RECEIVED,645400206,0,66195160426298fbb7e6659a187c8ed3ceab49c4923afe6ca27b349d4e68f2ad,22924745724
2022-11-03T01:26:00Z,PAYMENT SENT,0,-634590585,fa5f73296a3dbdd620e7f03285524915938414bece494b62c31e3114451e8b3f,22290155139
2022-11-03T00:30:10Z,PAYMENT SENT,0,-2562655857,c9cbfb7bea8817f53ef7d90bb9335bf52c3c8f4f16106fdd79f6f8d61e2d06ae,22279345518
2022-11-03T00:29:17Z,PAYMENT RECEIVED,644691067,0,1ac622b12ea5aea7bd9594159ce7876af1092ca0623be6671913d349cb8c00f7,24842001375
2022-11-02T23:20:45Z,PAYMENT RECEIVED,645674358,0,a18c2db5e5ac82cdad47418d7b622323315b45096f5aea242925fab63bd84e48,24197310308
2022-11-02T21:32:35Z,PAYMENT SENT,0,-1274552949,9a61d368234f524ecaead8ccf6164516200a39cd97d3da10fa5415e741e2005c,23551635950
2022-11-02T20:10:53Z,PAYMENT RECEIVED,657488993,0,eb18717012e370c224b77e64bfc23b16ec0512ad4f14b728882f485b71ace671,24826188899
2022-11-02T19:45:55Z,PAYMENT SENT,0,-1279135982,e97faf675d8a89df0a69be9621ec53700d8e875534069e6a48c6b71f2530f5c7,24168699906
2022-11-02T19:14:13Z,PAYMENT RECEIVED,660072440,0,c9dc38ba4ebadb4639039233e89a0d859bc15da35f51db9566d9171519a57ec7,25447835888
2022-11-02T15:51:44Z,PAYMENT RECEIVED,635855353,0,a4ab43ab01a6cbb7330bedb5f9acd309634d592d2fa21b8a69dc857a24df05db,24787763448
2022-11-02T15:22:35Z,PAYMENT RECEIVED,639221496,0,868c8007c93877a4565e7c09ef4d66d22b475fc70d1d306c63d9746d205ba8eb,24151908095
2022-11-02T15:02:20Z,PAYMENT RECEIVED,629843730,0,ff38e16abf649ee13429249d30c6049585353e9b999a10f4baf6cc6cfbae35d2,23512686599
2022-11-02T14:48:01Z,PAYMENT RECEIVED,629693410,0,72af587808eb7c8963856d2fc86e73e1483f19e25feb4e15a3674368fa84cba5,22882842869
2022-11-02T14:44:09Z,PAYMENT RECEIVED,634118141,0,4e3d5e49500345c090241121e66b741c689fba017cd5130d50166269d1e6e0e2,22253149459
2022-11-02T14:30:53Z,PAYMENT RECEIVED,636650888,0,e86319818d0e883dba3fa03086e4ede59d787ef3e4adc6f47b7fec737a950e98,21619031318
2022-11-02T14:08:44Z,PAYMENT RECEIVED,629255011,0,f2d0173b4b2777458bd8d83ec9528f652f9d6f8d0163b53ab655ea3a68ba5c4a,20982380430
2022-11-02T13:54:07Z,PAYMENT SENT,0,-2580195746,5b08aca35e0be98c981a7cf1e5de92ce3a7965916b09022fa3f8c01c4f22322b,20353125419
2022-11-02T13:48:37Z,PAYMENT RECEIVED,625000000,0,d4e3d5d42e40c64116aa992c97459db2d7373ea31181a4eb2475e32ad720eb73,22933321165
2022-11-02T13:24:51Z,PAYMENT RECEIVED,654331333,0,53cd5d16898e950ace8f1cc62d06b1119dd59bf78d819610ec801f8926132b8e,22308321165
2022-11-02T12:48:43Z,PAYMENT RECEIVED,654475972,0,5d2efabb12eed3166819893ab7610dabf206861350d02aebc0de0e9524f95cff,21653989832
2022-11-02T11:59:24Z,PAYMENT RECEIVED,646978549,0,9a3031bce4063d6f2ba900a7038f561662070aa39793393d0717c3de7b1d51cf,20999513860
2022-11-02T11:10:50Z,PAYMENT RECEIVED,636754617,0,3cfed71f65985a624af6e4762106957825ec904512c0cbaab2392fc3be4bf950,20352535311
2022-11-02T11:09:43Z,PAYMENT RECEIVED,646340737,0,7d9089c13bacf019c7491791ce46e7dabef7a2f0681da1716d6e0dc72e68e4ea,19715780694
2022-11-02T10:44:30Z,PAYMENT RECEIVED,639835500,0,488f760af3b786f42817d0b8e4c96f635392eac5d0ef2351fc80f5dda068e37b,19069439957
2022-11-02T10:42:08Z,PAYMENT SENT,0,-641585731,63e6b41757f5e7a8b2a8c89763f6943fe6020ffe87787bb935027831cd2d28af,18429604457
2022-11-02T09:07:27Z,PAYMENT RECEIVED,625820233,0,8b064e79bdf26ad7d681f64c81af4d60d602d81963728f6f054b358d827ccb14,19071190188
2022-11-02T09:06:25Z,PAYMENT RECEIVED,636227701,0,8ce77744823d49dfecb3eeddfcc6dab850a65574765b4b8fafe5278e50b92e2c,19095177603
2022-11-02T09:06:25Z,PAYMENT SENT,0,-649807648,768c866866874b429003af6ee7812cb63b6b4b7d090d745bc7be2d09cfcb408f,18445369955
2022-11-02T08:30:54Z,PAYMENT RECEIVED,632410314,0,14ae188f057a34eaa491439234c05ab4a53566c144403d5ebea923f56071fe9d,18458949902
2022-11-02T07:24:29Z,PAYMENT RECEIVED,640883807,0,755d7ee9207a71048598baf7a9a4ead5c60c045827eb0680322e205f0fc5c628,17826539588
2022-11-02T06:13:55Z,PAYMENT RECEIVED,626711248,0,e3152dcf038bbdb182437f8d2390dc71fa518e1e6fc3c9721693867ce5c9ed35,17185655781
2022-11-02T05:42:35Z,PAYMENT RECEIVED,629825269,0,dd366dc8831bf007c6db6498a4a5ede0aee05db9f223550ac90ffbac2d8cc6f5,16558944533
2022-11-02T04:57:36Z,PAYMENT RECEIVED,627153880,0,58d3dd7cda84fb413d60554c70362212b60e0d933ff0a6142c73f7b47ba49322,15929119264
2022-11-02T04:23:51Z,PAYMENT RECEIVED,631782042,0,aa38518fd9496c10247a54fe1064883d4b293ca3022dcdaa2b58c60c882bd4b5,15301965384
2022-11-02T03:33:03Z,PAYMENT RECEIVED,630483678,0,310a63f34ca2654f085c23846ece0d5ea36c3e72428dd325cd3ace38113115cb,14670183342
2022-11-02T02:33:03Z,PAYMENT RECEIVED,630995866,0,b554ead71d12a7e7ba90ac76055338b5ecb3d0529f1b99c33f2acee2191dd1be,14039699664
2022-11-02T02:09:47Z,PAYMENT RECEIVED,632819183,0,a1ff0abea9a9b1d14d1630b992e0a986349d20302088a61a4f98933edc5dec8e,18419763703
2022-11-02T02:09:47Z,PAYMENT SENT,0,-5011059905,2bf938fcec5da257c77740b1ea5b2c13aa5c77a978cc960777b65c2556fae06d,13408703798
2022-11-02T01:52:24Z,PAYMENT SENT,0,-630323601,cb29cbbadccb909f7048e10234ab10150cdfe1522a345bb42423d082e656dce2,17786944520
2022-11-02T00:59:28Z,PAYMENT RECEIVED,638182012,0,809e95d7afcfeb68c3f00eeef9c64f278610aae0cd77a90d3378bc8db1cd0a4a,18417268121
2022-11-02T00:37:05Z,PAYMENT RECEIVED,626774560,0,fab9b7340a3c9f9a10bb3fa48e529ce87baf79f6f74b5f3cd2e72596e5429d5e,17779086109
2022-11-02T00:09:45Z,PAYMENT RECEIVED,641641074,0,3123f99951f48fe711c98c78b4cd07fbbecda744c48c723de81431cf3cc0aad0,17152311549
2022-11-01T23:59:12Z,PAYMENT RECEIVED,634590585,0,9b679c2d99341eead83de7f8327b5e708b6310acbc249e4977f9c6958f3ccd0a,16510670475
2022-11-01T22:27:09Z,PAYMENT RECEIVED,631852708,0,8d35ab55cd1e16c079bc6f17aff2a49f740d5c783b96bf43399825cfd0e907cb,15876079890
2022-11-01T22:26:00Z,PAYMENT SENT,0,-3182173770,79762feb4cc584d7c2f354bd24acb1b33c3425690a345cec41cf53aeeafa1ef4,15244227182
2022-11-01T21:19:26Z,PAYMENT RECEIVED,640987015,0,b91070cda450e5eb77fc538a8d0d9db51d55fbf176d0fe48e655819e8aeb2a63,18426400952
2022-11-01T19:26:40Z,PAYMENT SENT,0,-1925279152,a0ef8df17ae6e3a008d79b123c675329a41dbe98fbe59294f2ccdf314874de3f,17785413937
2022-11-01T18:59:32Z,PAYMENT RECEIVED,640380934,0,547c7672a3b625baab1cdb6c078f67c2d32be0c0892c500036ba4b7797275fe6,19710693089
2022-11-01T18:51:28Z,PAYMENT RECEIVED,648886681,0,e35c269def94e57363e7d3783d3efa8652c90caa8c545ca581ec61ee157a51cb,19070312155
2022-11-01T18:02:41Z,PAYMENT RECEIVED,640789328,0,8a96a05d28cec11c97cc3dde5b00b671016c0ee967815b3c6f218e66568a94f5,18421425474
2022-11-01T17:42:12Z,PAYMENT RECEIVED,640904554,0,fae3d28973c214090583954d63a4363af9188a5f4274e005056ec4ae9f4c5da7,20328224762
2022-11-01T17:42:12Z,PAYMENT SENT,0,-2547588616,ad70ca19e27d9a6b9c8ee653f6d3be3a3f2ef113535220b1d1ed44d75a45ad91,17780636146
2022-11-01T17:30:36Z,PAYMENT RECEIVED,649615183,0,25a210927b102ed101535893dec5455716b2bb3a3ffb663ddff8aa2673332e61,19687320208
2022-11-01T16:46:39Z,PAYMENT SENT,0,-1893298246,f7fb731e50bc884afba4cfcc458e8ddb2d87677d511e2e656ff89d9e52f76220,19037705025
2022-11-01T16:12:55Z,PAYMENT RECEIVED,637494908,0,75ac0dd48698162bc1223868696337050b7589e1ffe6ca0bed7a6abf1bc2e954,20931003271
2022-11-01T15:41:35Z,PAYMENT RECEIVED,641585731,0,d774ad26bc097b16388cc212626df59f320bfe5c2d7c51377263c157b2ba018b,20293508363
2022-11-01T15:32:37Z,PAYMENT RECEIVED,649807648,0,d232ca839079b1da25924d8cc06670079e22b9a889b17499f17b594432ba7e47,19651922632
2022-11-01T14:06:49Z,PAYMENT RECEIVED,640600635,0,dc8934d8f758bd6eade95255aba220dcbd9300a9a9f21bf4b976ad6a424addd6,19002114984
2022-11-01T13:28:35Z,PAYMENT RECEIVED,630999509,0,7a6d6ddef57890e5529ffa422074e2e168dc0d3e956c4ce76f276216cefc865f,20263824394
2022-11-01T13:28:35Z,PAYMENT SENT,0,-1902310045,44e1ba8335836f5fba3322a768647da4d6c7613117ee37ec995f847c9c52021c,18361514349
2022-11-01T12:57:45Z,PAYMENT RECEIVED,631673408,0,44f9a109f9c74b294a7f2f9f0f34ec599adb6d2d48d2b2bcaf2128c5dc601e55,19632824885
2022-11-01T12:43:05Z,PAYMENT RECEIVED,631775390,0,cb3137fe7b4a91210b5651cd097da55aac482e17be00349d3c99e99dc301ceb6,19635876286
2022-11-01T12:43:05Z,PAYMENT SENT,0,-634724809,52546a8b36eade1db073a8d67998267984728123c290f7da763d0b30e053fa17,19001151477
2022-11-01T11:23:46Z,PAYMENT RECEIVED,636370937,0,775345a28d90abd7f1997b4dd7570cc9d5f2d3f39a5291b003ba3043c221cd2b,19004100896
2022-11-01T11:03:29Z,PAYMENT SENT,0,-1288203204,a7587fa9256efb19249be04349b0f0648ff7428752ddcb210291c411e49780c9,18367729959
2022-11-01T10:09:47Z,PAYMENT RECEIVED,640687273,0,0ad0056c68be3986e527639597a898e8f158fff8e82d90d5f40ec08bc905481a,19655933163
2022-11-01T09:46:11Z,PAYMENT RECEIVED,625607313,0,4509d2447954607bd89945013e4a92e83d244d1b59251b17b9f3cd781192c07a,19015245890
2022-11-01T09:29:50Z,PAYMENT SENT,0,-643622137,549b401bc3ecbe4670fe12b8d7c12961883365410fa603eb1d1b56c4fddf83ec,18389638577
2022-11-01T09:28:11Z,PAYMENT RECEIVED,630323601,0,8b61957765f5071af9f2520821192483693a52b222c04060ace73b334f010755,19033260714
2022-11-01T08:41:43Z,PAYMENT SENT,0,-1292797279,779e2a4c07011036905ab85e3b79fdda3a3003ebdf33eb22e195d48855244a94,18402937113
2022-11-01T07:38:49Z,PAYMENT RECEIVED,640121791,0,42cf681a53573cab037a9974f139bd956e27623f1d03abd4fefcde1eda9d094a,19695734392
2022-11-01T06:25:14Z,PAYMENT RECEIVED,631639685,0,d16ba2b64870703b3648cdc0cbd472bb87e905a6f0e563d0d96d2e8a8689ef8f,19055612601
2022-11-01T05:16:24Z,PAYMENT RECEIVED,645026294,0,4163460b2064077674e27eb37d506a8891bd18ade942aed5a7a68a36e7a1fe43,18423972916
2022-11-01T04:37:58Z,PAYMENT RECEIVED,636383744,0,dc14b5b258bffd20418a62a4b212629e58febdf21f9ca4496ee4ae8c2934b091,17778946622
2022-11-01T04:15:44Z,PAYMENT RECEIVED,632063602,0,f22db975be745b9b4f9ae52d77af3ec3ef498f954f02879823fcdcd9c63a250e,17142562878
2022-11-01T04:06:41Z,PAYMENT RECEIVED,640337801,0,4f5903e746bd5957d3dc02f058a1aed7014d31efc7409d8cc4014c1e99318ec0,16510499276
2022-11-01T03:38:42Z,PAYMENT SENT,0,-1251096114,88fbbd8e3b97751fae29f1226a398b57b9342831bd57f245c4d9227daf9effec,15870161475
2022-11-01T03:32:37Z,PAYMENT RECEIVED,652877749,0,3f9159e3128c3b4eb0bda739caec9289a3ebeee3a6d10bb62b574d5507ac0400,17121257589
2022-11-01T02:21:46Z,PAYMENT SENT,0,-5657308656,fc5a07c15c629534047493ab6083f856e5ac2079fe59a8b21f0354019bb911cd,16468379840
2022-11-01T00:26:57Z,PAYMENT RECEIVED,646599553,0,b8dc464e2412c36dabc529971733be5e8c0cd38ee1da29ce46502274d0d914f8,22125688496
